full brick	全砖
full-brick	全砖
first time offer	首次出售
Handy Location	便利位置
Handy Position	便利位置
convenient location	便利位置
convenient position	便利位置
light filled	采光好的
light-filled	采光好的
perfect location	優越位置
prime location	優越位置
family entertainer	 家庭娱乐室
executive living 	時尚生活
executive home	時尚生活
close to station	近车站
proximity to station	近车站
walkable to station	近车站
walk to station	近车站
fully furnished	家具齐全
fuly-furnished	家具齐全
granny flat	祖母房
deposit taken
brand new	全新
bathroom    	卫生间
open plan	開放式
low maintenance	易打理
easy access	轻松直通
high ceilings	高天花
main bathroom	主浴室
stainless steel	不锈钢
internal laundry	内部洗衣房
open plan	開放式空間
low maintenance	易打理
easy access	轻松直通
high ceilings	高天花
main bathroom	主浴室
stainless steel	不锈钢
internal laundry	内部洗衣房
natural light	天然采光
short walk	輕鬆步达
first home	第一家
formal lounge	正統客廳
internal access	内部直通
built-in robes	内置衣櫃
public transport	方便公交
walk-in robe	步入衣柜
double garage	双车库
large bedrooms	宽敞卧室
lock-up garage	锁车库
full brick	全砖建设
modern kitchen	现代厨房
spacious bedrooms	宽敞卧室
single level	单独楼层
local shops	当地商店
short stroll	輕鬆步至
close proximity	便捷位置
separate toilet	独立卫生间
double brick	双砖建设
top floor	最高楼层
double bedrooms	双卧室
generous bedrooms	宽大卧室
rare opportunity	难得机会
evaporative cooling	蒸发空调
main bedroom	主卧室
local schools	临近学校
quiet street	安静街道
high side	高边街区
ample storage	充足存储間
short drive	车程便捷
reverse cycle	循环空调
built-in wardrobes	内置衣柜
entertaining area	娱乐区
separate bath	独立浴缸
first time	首次
good size	宽大慷慨
new home	新家
separate dining	独立饭厅
upper level	上层
double carport	双车库
hot water	热水
high quality	高质
ducted heating	管道暖气
french doors	法式大门
formal dining	正规饭厅
central bathroom	中央浴室
spacious living	宽敞客厅
separate shower	独立淋浴间
easy care	易护理
large family	大家庭
first floor	一楼
polished timber	抛光木版
rear garden	后花园
own enquiries	自己查询
casual living	休闲生活
alfresco area	露天区域
private balcony	私人阳台
separate lounge	独立家庭室
great opportunity	绝佳机会
private schools	私立学校
formal living	家庭生活区
separate laundry	独立洗衣
separate living	独立生活区
young families	年轻家庭
spacious lounge	宽敞生活区
easy walk	容易步达
modern bathroom	现代浴室
multiple living	多生活区
private courtyard	私家庭院
easy reach	容易到达
full bathroom	完整浴室
walk-in wardrobe	步入式衣橱
perfect place	完美地段
informal living	休闲生活区
new carpet	崭新地毯
quiet cul-de-sac	安静胡同
solar panels	太阳能电板
direct access	直接通达
prime location	优越位置
european appliances	欧式家电
other features	其他优点
spacious family	宽敞家庭
rear yard	后方花园
spa bath	温泉卫浴
granite bench	花岗岩坪
in-ground pool	坐地游泳池
lift access	电梯直通
full ensuite	全套房
contemporary style	摩登风格
open fireplace	开放火炉
convenient location	便捷位置
total area	总面积
bi-fold doors	双折门
fantastic opportunity	绝佳机会
generous proportions	慷慨比例
interested parties	有兴趣人士
double lock	双锁
dual level	双层
few minutes	数分钟
generous size	空间慷慨
contemporary living	优雅生活
large living	宽敞生活区
walk-in pantry	茶水间
new kitchen	崭新厨房
north aspect	受欢迎之北向
outdoor living	户外生活
easy stroll	轻松漫步
following tabs	下面标签
other websites	其他网站
single lock	单锁
high end	高端
rental return	租金回报
great location	优越位置
off-street parking	街边车位
secondary schools	中学
spacious kitchen	宽敞厨房
generous living	慷慨生活区
built-in wardrobe	内置衣柜
main living	主要生活区
modern bathrooms	现代浴室
real estate	房地产
astute investor	精明投资者
leafy outlook	绿荫景观
primary school	小学
rental income	租金收入
single garage	单车库
modern apartment	现代公寓
north facing	北向
panoramic views	全景
prospective purchasers	准买家
side access	侧门通达
exciting opportunity	绝佳机缘
great investment	绝佳投资
modern living	现代生活区
open living	开放生活区
open-plan living	开放式生活区
casual meals	休闲餐室
central location	中央位置
dining room	餐厅
large laundry	大型洗衣间
modern family	现代家庭区
neutral tones	和谐色调
built-in robe	内置衣柜
eat-in kitchen	方便厨房
excellent opportunity	上佳机会
large storage	宽敞存储量
new family	新家庭
outdoor entertaining	户外娱乐
granite benchtops	花岗岩台面
quiet location	安静位置
remote garage	遥控车库
additional bedrooms	额外卧室
internal entry	内部入口
living area	生活区
private ensuite	私人套房
catchment area	学区
large master	大主卧
local buses	临近公车
single carport	独立车库
well-appointed kitchen	全设备厨房
built ins	内置衣櫃
built-ins	内置衣櫃
contemporary design	时代设计
elevated position	高边位置
front door	前门
northerly aspect	面北方向
separate family	单独家庭区
short distance	短距离
solid brick	实砖建设
stylish bathroom	时尚浴室
walk-in robes	步入式衣柜
additional features	附加优点
ideal investment	理想投资之选
outdoor area	室外区域
tree-lined street	绿树成荫街
bench space	长凳空间
cupboard space	橱柜空间
dual living	双重生活
internal laundry-	内部洗衣房
local amenities	本地设施
major shopping	购物天堂
modern ensuite	现代套房
young family	年轻家庭
ample cupboard	充足橱柜
attic storage	阁楼存储
double storey	双层
first homebuyers	首次购房者
sought-after location	抢手位置
spacious interiors	宽敞内部
spacious master	宽敞主卧
casual dining	休闲餐饮
contemporary kitchen	现代厨房
large lounge	寬敞客廳
light-filled living	采光生活区
private garden	私家花园
solid timber	实木
astute investors	精明投资者
extra storage	额外存储空间
primary schools	小学
rear access	背后直通
second bedroom	次卧室
stainless-steel appliances	不锈钢器具
contemporary home	当代家居
excellent storage	优良贮存
large kitchen	大厨房
large windows	大窗户
long term	长期
separate powder	独立卫浴
top quality	一流质量
central kitchen	中央厨房
excellent schools	优秀学校
floor-to-ceiling tiles	鋪磚墻面
local cafes	本地咖啡馆
modern home	现代家居
new apartment	新公寓
stainless appliances	不锈钢器具
beautiful home	美丽家园
contemporary interiors	高档设计
covered alfresco	有蓋露天區
european laundry	欧式洗衣房
large balcony	大阳台
light rail	轻轨
popular schools	优秀学校
whole family	全家人
wide frontage	宽敞街面
dual street	双街面
easy living	简单生活
exceptional family	优秀家庭
fresh paint	崭新油漆
further details	进一步细节
outstanding opportunity	优秀机会
perfect family	完美家庭
perfect opportunity	完美机会
relaxed family	轻松家庭
unbeatable location	绝佳位置
californian bungalow	加州平房
double vanity	双洗盆
front garden	前园
landscaped gardens	绿荫花园
large bedroom	大卧室
new luxury	崭新豪华
remote control	远程控制
second toilet	次卫浴
ample space	充足空间
blank canvas	创作白稿
blue ribbon	蓝带
expansive living	广阔生活
internal laundry*	内部洗衣房
local shopping	本地购物
neutral colour	和谐色调
ornate ceilings	华丽天花
other amenities	其他设施
premium location	优越地理
separate wc	独立卫生间
comfortable family	舒适家庭
comfortable living	舒适生活
easy maintenance	易于维护
ensuite bathroom	卫浴间
entertaining spaces	娱乐空间
further information	进一步信息
high ornate	高档华丽
local eateries	本地餐馆
modern finishes	现代修饰
open fire	开放火炉
original condition	古早状态
original kitchen	古早厨房
polished floorboards	打磨地板
public schools	公立学校
separate study	独立書房
single car	单辆车
spacious layout	宽敞布局
spectacular views	壮观景色
square metres	平方米
square meters	平方米
additional robed	额外衣柜
bright interiors	明亮室内
common wall	共用墻
convenient position	位置便利
exceptional opportunity	特殊机会
full length	全长
huge backyard	巨大后院
ideal opportunity	理想机会
large families	大家庭
local parks	邻近公园
modern appliances	现代家电
modern interiors	现代室内设计
remote-control garage	遥控车库
second bathroom	第二浴室
spacious bedroom	宽敞卧室
stylish kitchen	时尚厨房
tasmanian oak	塔斯马尼亚橡木
tiled floors	鋪磚地板
wonderful opportunity	极好机会
built-in storage	内置存储间
cathedral ceilings	大教堂天花
contemporary family	美丽家庭
double size	两倍大小
dual occupancy	双双入住
express city	都市快车
further highlights	更显得
granite kitchen	花岗岩厨房
large backyard	大后院
level lawn	水平草坪
lifestyle opportunity	优秀生活
perfect home	完美家居
rapid access	快速直通
separate storage	单独存储间
slow combustion	慢燃
stunning home	驚艷家居
stunning apartment	驚艷家居
sunny balcony	采光阳台
third bedroom	第三卧室
wet bar	酒吧
central family	核心家庭
covered entertainment	有蓋娱乐區
east aspect	面东方向
external access	外部直通
fantastic property	出色地段
flexible floorplan	灵活布局
full size	全面大小
good-sized bedrooms	大卧室
ideal place	理想地方
inner city	城市内部
local bus	邻近公交
modern updates	现代修饰
open-plan kitchen	开放式厨房
quick access	快速直通
quiet tree	安静树荫
recreational facilities	娱乐设施
separate w/c	独立卫浴
small complex	小区
solar power	太阳能
updated bathroom	以裝修浴室
abundant storage	丰富存储间
additional parking	额外车位
additional storage	额外存储室
central heating	中央暖气
contemporary apartment	時尚公寓
covered balcony	有蓋阳台
covered outdoor	有蓋露天區
dining area	餐饮区
double bedroom	双卧室
double doors	双扇门
double remote	双遥控
en suite	套房
fourth bedroom	第四卧室
functional kitchen	功能齐全厨房
generous lounge	慷慨休息室
large bathroom	大浴室
large study	大书房
new carpets	新地毯
open lounge	开放式客廳
other bedrooms	另一卧室
quiet cul	安静小路
second living	第二生活区
single storey	单层
unique opportunity	独特机会
wide driveway	宽阔车道
automatic garage	自动车库
central hallway	中央走廊
child-friendly level	適合兒童区
decorative ceilings	漂亮天花板
door step	门口台阶
great home	漂亮住宅
indoor/outdoor living	室内/室外生活区
large pantry	大厨房
other highlights	其他优点
seamless indoor/outdoor	天衣无缝户内/户外
spacious apartment	宽敞公寓
stunning views	迷人景色
ultimate convenience	位置便利
ample bench	充足桌面
corporate fees	物业费
east facing	面东方向
easy commute	简易通勤
future development	未来发展
hard work	艰苦工作
in-ground swimming	入地游泳池
large block	大地段
leafy views	绿荫景色
lifestyle appeal	简易生活
north-east facing	面东北方向
outdoor awnings	有盖户外
outdoor kitchen	户外厨房
outstanding location	優越地段
own investigations	自己调查
rental returns	優越租金回报
undercover alfresco	露天室外区
unique property	独特地段
well-proportioned bedrooms	匀称卧室
added bonus	附加优点
beautiful family	美丽家庭
contemporary comfort	现代舒适
east side	东区
entertaining deck	甲板娱乐区
gorgeous timber	华丽木材
grand scale	盛大规模
granny flat	祖母公寓
high ceiling	高天花
high schools	高中
huge living	巨大生活区
internal living	内部生活区
leafy surrounds	绿叶环绕
metre frontage	平方米向街面
meter frontage	平方米向街面
modern design	现代设计
new residence	全新住所
outdoor entertainment	户外娱乐区
perfect blend	完美融合
prestigious schools	名校林立
prime position	绝佳位置
rear lane	尾巷
salt water	盐水
savvy investor	精明投资者
second floor	二楼
several cars	几辆汽车
ample room	充足房间
balcony access	阳台直通
built-in robes-	内置衣柜
cul-de-sac location	胡同位置
double shower	双淋浴
elite schools	精英学校
european style	欧式风格
extended family	大家庭
extra features	额外特点
flexible floor	弹性地板
future potential	潜利
generous floor	宽大楼层
heated pool	温水游泳池
high demand	高需
high gloss	抛光
internal lift	内部电梯
local parklands	邻近公园
modern style	现代风格
natural sunlight	自然阳光
new owner	新主人
open design	开放式设计
open kitchen	开放式厨房
original features	古早特征
original timber	原木材
outdoor space	户外空间
peaceful street	安静街道
polished floors	抛光地板
premium finishes	高等修饰
private backyard	私人后院
private gardens	私家园林
rare find	罕见
rare offering	罕见
ultra-convenient location	便捷位置
big bedrooms	大卧室
close drawers	关闭抽屉
contemporary residence	当代住宅
covered deck	有蓋甲板
current owners	目前业主
decorative cornices	飞檐装饰
desirable location	理想位置
dual access	双双直通
electric oven	电烤箱
excellent condition	良好条件
exceptional home	特殊家
floor-to-ceiling glass	落地玻璃
full width	全宽度
generous layout	慷慨布局
great place	优等地段
great storage	优等储存间
indoor pool	室内游泳池
lifestyle excellence	卓越生活方式
living room	客厅
lock-up storage	带锁存储
low rise	低层
low strata	低物业费
luxurious comfort	豪华舒适
luxurious master	豪华主人房
manicured gardens	漂亮花园
multi-purpose room	多功能空间
next door	隔壁
northern sun	面北太阳
ocean views	漂亮海景
open floor	开放式
open space	开放空间
original bathroom	古早浴室
own driveway	自己车道
popular cafes	受欢迎咖啡
popular eateries	受欢迎餐馆
popular location	热门地点
public school	公立学校
rear courtyard	后院
relaxed living	轻松生活
remote door	遥控门
sqm block	平方米块
storey residence	层住宅
stylish interiors	时尚内饰
tropical gardens	热带花园
underfloor heating	采暖地板
updated kitchen	新修厨房
versatile floor	多功能布局
alfresco terrace	露天阳台
american oak	美国橡木
arterial roads	交通便捷
built-in robes*	内置衣柜
central living	中央生活
circular driveway	圆形车道
ducted air	管道空调
duplex site	duplex区
easy flow	舒服易通
entertaining space	娱乐空间
fantastic home	梦幻般家
flexible living	灵活生活
foreign investment	外国投资
formal lounge/dining	正规客厅
full advantage	充分利用
garden views	花园景色
generous family	慷慨家庭区
great family	漂亮家庭
great features	华丽特点
great size	慷慨尺寸
huge family	庞大家庭区
idyllic lifestyle	天堂般生活
large level	慷慨楼层
light-filled lounge	采光客厅
long day	疲惫一天
new homes	新家园
new owners	新主人
northern aspect	面北方向
private entrance	私人入口
small block	小地段
solar system	太阳能系统
spacious balcony	宽敞阳台
spacious home	宽敞家区
under-house storage	地库储存间
wonderful family	美好家庭
advertised time	广告时间
alfresco deck	露天甲板
amazing opportunity	惊人机会
balcony- modern	阳台-现代
bright living	美好生活
classic home	经典家居
combined living	结合生活
common walls	共用墻
cupboard storage	橱柜储存
double car	双车库
dual vanity	双洗盆
everyday living	每天生活
excellent investment	优良投资
extra toilet	额外卫浴
fantastic investment	出色投资
fantastic location	极好位置
first class	头等
frameless shower	无框淋浴
frequent city	频繁城市
further bedrooms	更多卧室
generous master	慷慨主人房
golden opportunity	千载难逢机
good storage	良好储存
great property	漂亮地段
immaculate condition	完美条件
large feature	慷慨特点
leadlight windows	雕花灯窗
leafy outlooks	叶观美景
light stream	采光
light-filled interiors	采光内部
local primary	邻近小学
l-shaped lounge	L形客厅
new timber	新木材
open study	开放性书房
oversized bedrooms	超大卧室
private alfresco	私人户外区
private entry	私人入口
quiet court	安静庭院
rear deck	后面甲板活动区
relaxed lifestyle	轻松生活方式
savvy investors	精明投资者
second level	二楼层
sleek kitchen	时尚厨房
solar electricity	太阳能
stunning family	惊人家庭区
sunny north	采光面北
sweeping views	一览无余
ultimate family	顶级家庭区
undercover car	有盖车位
underhouse storage	地库储存间
well-equipped kitchen	设备齐全厨房
wide range	多选择
additional living	额外生活区
beautiful timber	上佳木材
built-in bbq	内置烧烤炉
combined lounge	结合客厅
contemporary renovation	时尚装修
cul-de-sac setting	胡同地段
double tandem	双车位
enormous potential	巨大潜力
entertaining terrace	娱乐区
enviable lifestyle	令人羡慕生活
full height	全高
further capitalise	进一步利用
house-like proportions	房子一样比例
intercom entry	对讲机入境
interior design	室内设计
large breakfast	大早餐区
large rumpus	大型娱乐区
lifestyle location	生活方式定位
light fittings	灯具
luxurious living	奢华生活
main road	主要道路
many years	许多年
modern comfort	现代舒适
modern gas	现代煤气家具
neat bathroom	整洁浴室
new paint	崭新油漆
open layout	开放式布局
outstanding family	优秀家庭区
perfect investment	完美投资
perfect location	完美位置
perfect spot	完美地段
private retreat	私人书房
quick drive	位置便利
quiet position	安静位置
rental demand	租赁高需
separate studio	独立工作室
solar panel	太阳能
stylish apartment	时尚公寓
tiled bathroom	瓷砖浴室
top level	顶层
ultra convenient	超方便
wide street	宽阔大街面
additional car	额外车位
affordable price	实惠价格
architectural design	建筑设计
architectural masterpiece	建筑杰作
contemporary finishes	时尚装修
contemporary lifestyle	现代生活方式
double door	双式门
endless potential	无穷潜力
entertaining areas	娱乐区
exceptional lifestyle	独特生活方式
fifth bedroom	第五卧室
flexible layout	灵活布局
floor-to-ceiling windows	落地窗
front yard	前院
full bathrooms	完整浴室
good quality	高质量
great layout	优质布局
green spaces	绿色空间
high ceilings-	高天花板
ideal home	理想家居
ideal location	理想位置
internal access-	内部直通
lane access	小巷直通
large island	宽敞厨房桌
level access	直通
luxurious family	豪华家庭区
magnificent views	壮丽景色
many features	多功能
marble kitchen	大理石厨房
neat kitchen	整洁厨房
new bathroom	新浴室
new benchmark	新基准
other local	其他地方
outdoor pool	室外游泳池
paved courtyard	铺就庭院
peaceful location	安静位置
peaceful setting	安静环境
private access	私人直通
private home	私人住宅
private terrace	私人露台
prized location	珍贵地段
renovated kitchen	装修厨房
s/s appliances	s／s家电
separate bathroom	独立浴室
separate entrance	单独入口
separate kitchen	独立厨房
sought-after street	抢手街区
spacious residence	宽敞住宅
strong growth	强劲增长
sunny aspect	采光面向
super convenient	超级方便
timber floors	木地板
total land	土地总
additional highlights	其他亮点
aquatic centre	水运中心
beautiful garden	美丽花园
cathedral ceiling	大教堂天花版
cheerful kitchen	优良布局厨房
complete privacy	完全隐私
contemporary bathroom	时尚浴室
contemporary sophistication	时尚装修
convenient access	方便直达
convenient lifestyle	方便生活方式
deluxe ensuite	豪华套间
desirable floor	理想地板
double glazing	双层玻璃窗
double sink	双水槽
electric cooking	电灶
enviable location	羡慕地段
european oak	欧式橡木
excellent location	优越地位
exclusive listing	独家上市
external laundry	外部洗衣房
extra parking	额外停车场
fantastic family	梦幻般家庭
floor-to-ceiling tiles-	鋪磚墻面
following features	以下功能
free-standing bath	独立式浴缸
full bath	全身浴
granite benches	花岗岩长凳
great condition	优越精整
handy location	方便位置
high level	高楼层
high school	高中
huge block	巨大地段
idyllic family	田园诗般家庭区
impressive home	极美家居
inground pool	室外游泳池
large ensuite	特大套间
lockable storage	带锁存储
maintained security	有保安
marble ensuite	大理石浴室
massive master	巨大主人房
middle floor	中间楼层
open home	开放式家居
outdoor spaces	户外空间
outdoor terrace	户外露台区
own inspections	自己检查
personal touch	个人精修
prime corner	黄金地段
private deck	私人甲板区
private driveway	私人车道
private inspection	检查
private leafy	私人绿荫
private outdoor	私人户外
private yard	私人庭院
prized north	珍贵北向
same family	一家人
single lockup	单锁
single remote	单个远程
small security	小保安
sought-after area	抢手地区
spacious design	宽敞设计
spacious floor	宽敞loucq
storage- internal	内部存储间
storey home	层楼家居
strong rent	极优租金
stunning property	惊人地段
stylish bathrooms	时尚浴室
stylish family	时尚家庭区
superior quality	卓越品质
teen retreat	青少年生活区
timber floor	木地板
undercover area	有盖地区
undercover balcony	有盖阳台
urban living	城市生活
urban retreat	城市生活区
well-regarded schools	著名学校
lower level	低层
more information	更多信息
more bedrooms	更多卧室
guest powder	客人卫浴
best endeavours	尽最大努力
highest quality	最高质量
highest standard	最高标准
best streets	最好街道
finest streets	最好街道
guest accommodation	客人住宿间
highest standards	最高标准
% deposit	%存款
% pa	%回报率
% yield	%回报率
master bedroom	主卧室
secure basement	保险地下室
single carport	单车棚
single garage	单车库
3 bedrooms	3卧室
4 bedrooms	4卧室
ac unit	空调
abode offers	住宅提供
absolute privacy	绝对隐私
abundance shelving	充裕储存
access points	直达入点
accommodation comprises	住宅包括
accommodation features	住宅特点
acre block	英亩地段
acre property	英亩地段
acreage block	英亩地段
acreage lifestyle	乡村生活方式
acreage living	乡村生活方式
adjoining bathroom	链接式浴室
adjoining kitchen	链接式厨房
adjoining meals	链接式饭厅
afternoon sun	午后采光
aggregate driveway	车道
air circulation	空气循环
air con	空调
air conditioning	空调
air flow	通风
airy bathroom	通风浴室
airy bedrooms	通风卧室
airy interiors	通风室内
airy kitchen	通风厨房
alarm monitoring	警报监控
alarm system	警报监控
alarm system	警报系统
alarm throughout	警报系统
alfresco area	露天区
alfresco areas	露天区
alfresco balcony	露天阳台
alfresco balcony	露天阳台
alfresco courtyard	露天庭院
alfresco deck	露天甲板
alfresco dining	露天餐厅
alfresco entertainer	户外娱乐区
alfresco entertainers	户外娱乐区
alfresco entertaining	户外娱乐区
alfresco lounge	户外空间
alfresco patio	户外空间
alfresco retreat	户外空间
alfresco setting	户外娱乐区
alfresco settings	户外娱乐区
alfresco space	户外空间
alfresco spaces	户外空间
alfresco terrace	露天阳台
alfresco terraces	露天阳台
alfresco zone	户外空间
all-weather entertaining	全天候娱乐区
ambient light	漂亮光线
ample scope	充足的空间
anyone downsizing	适合小家庭
apartment block	公寓楼
apartment boasts	公寓拥有
apartment building	公寓楼
apartment captures	公寓包含
apartment complex	公寓
apartment delivers	公寓提供
apartment embodies	公寓提供
apartment features	公寓结合
apartment living	公寓生活
apartment offers	公寓提供
apartment presents	公寓提供
apartment rests	公寓位置
apartment showcases	公寓提供
apartment sits	公寓位于
apartments feature	公寓结合
appliance cupboard	电器柜
architect owner	建筑师业主
area adjacent	毗邻地区
area adjoins	地区毗邻
area approx	面积约
area boasts	地区拥有
area capture	区域包括
area comprises	区域包括
area connects	地区毗邻
area extends	地区延伸
area features	地区结合
area offers	地区提供
area overlooks	地区俯瞰
area sits	地区俯瞰
art designer	美术设计师
art kitchen	艺术厨房
art studio	艺术小间
arthouse film	艺术影片
artist impression	美观印象派
astute buyer	精明买家
attracts plenty	吸引了大量
auction location	拍卖地点
auto cleaning	自动清洗
auto door	自动门
auto doors	自动门
auto garage	自动车库
auto gate	自动门
auto gates	自动门
auto irrigation	自动灌溉
auto irrigationin	自动灌溉
auto lock	自动锁
automatic lock	自动锁
automation system	自动化系统
avid entertainer	娱乐区
backpackers accommodations	背包住宿
backyard features	后庭园结合
backyard garden	后庭园
backyard lawn	后院美坪
backyard poolside	后院泳池
backyard sanctuary	后院天堂
balcony access	阳台入口
balcony capturing	阳台提供
balcony combine	阳台提供
balcony deck	阳台甲板
balcony overlooks	阳台俯瞰
balcony setting	阳台娱乐区
balcony views*	阳台美景
bamboo flooring	竹制地板
bamboo hedges	竹篱笆
bamboo kitchen	竹制厨房
bamboo timber	竹制木材
banking opportunity	银行机缘
bar area	酒吧区
bar fridge	酒吧冰箱
bar kitchen	酒吧式厨房
barbecue area	烧烤区
barbecue deck	烧烤阳台
barbecue facilities	烧烤设备
barbecue terrace	烧烤露台
barbeque area	烧烤区
bargain hunters	精明买家
bargain property	超值家居
base security	基地警报
basement carpark	地下车库
basement garage	地下车库
basement level	地下层
basement storage	地下储藏室
basketball court	篮球场
basketball courts	篮球场
basketball hoop	篮球架
bath ensuite	浴室套房
bath room	浴房
bath tub	浴缸
bathroom comprises	浴室提供
bathroom facilities	卫浴设施
bathroom facility	卫生间设施
bathroom feature	浴室结合
bathroom features	浴室包含
bathroom offers	浴室包含
bathroom showcases	浴室柜
bathrooms feature	浴室包含
bay glimpses	港湾美景
bay views	港湾美景
bay window	港湾窗台
bay windows	港湾窗台
bayside community	港湾小区
bayside enclave	港湾小区
bayside lifestyle	海湾生活
bayside living	海滨生活
bayside location	海滨地区
bayside setting	海滨地区
beach lifestyle	海滩生活
beach side	海边
beachside living	海滨生活
beachside suburb	海滨小区
beautiful gardens	美丽花园
beautiful park	美丽公园
bedroom accommodation	卧住宿
bedroom apartment	卧公寓
bedroom apartments	卧公寓
bedroom layout	卧室布局
bedroom offers	卧室提供
bedroom property	卧家居
bedroom residence	卧家居
bedroom residences	卧家居
bedroom unit	卧公寓
bedroom units	卧公寓
bedroom villa	卧别墅
bedrooms home	卧家居
bedrooms unit	卧公寓
bench seating	长凳
bench top	台面
bench top•	台面
bench tops	台面
bench tops*	台面
bench tops•	台面
benchtop kitchen	台式厨房
bespoke cabinetry	定制橱柜
bespoke finishes	定制修饰
bespoke kitchen	定制厨房
bicycle paths	自行车道
bicycle track	自行车道
bike storage	自行车存放处
bike track	自行车道
bike tracks	自行车道
bike trail	自行车道
bike trails	自行车道
billiard table	台球桌
billiards room	台球室
bird song	鸟声
bitumen road	沥青路面
blank canvas	创作空间
blends luxury	豪华结合
block location	地区位置
block offers	地块提供
block position	地区位置
block presents	地块提供
blue chip	蓝筹
boat house	船屋
boat ramp	船用斜坡
boating facilities	划船设施
bottle cellar	酒窖
boutique apartment	精品公寓
boutique apartments	精品公寓
boutique block	精品街区
boutique building	精品建筑
boutique cafes	精品咖啡馆
boutique development	精品建筑
boutique hotel	精品酒店
boutique shopping	精品店
boutique shops	精品店
boutique style	精品风格
boutique townhouses	精品排屋
boutique waterfront	精品水滨
bowling club	保龄球俱乐部
breakaway space	分离空间
breakfast bar	早餐台面
breakfast bar-	早餐台面
breakfast bar*	早餐台面
breakfast bar.the	早餐台面
breakfast bar.tranquillity	早餐台面
breakfast bar•	早餐台面
breakfast barlarge	早餐台面
breakfast bench	早餐台面
breakfast counter	早餐台面
breakfast nook	早餐小台
breakfast room	早餐室
breathtaking home	精美家居
breathtaking outlook	惊叹美景
breathtaking parkland	惊叹园景
breathtaking views	壮丽景色
breezy interiors	简洁内饰
breezy living	轻松生活
brick apartment	全砖公寓
brick bbq	全砖烧烤区
brick building	全砖建筑
brick bungalow	全砖平房
brick complex	全砖建筑
brick complex-	全砖建筑
brick construction	全砖建筑
brick construction-	全砖建筑
brick construction*	全砖建筑
brick construction•	全砖建筑
brick constructions	全砖建筑
brick cottage	全砖平房
brick courtyard	铺砖庭院
brick design	全砖设计
brick downstairs-	全砖楼下
brick duplex	全砖建筑
brick dwelling	全砖建筑
brick facade	全砖立面
brick façade	全砖立面
brick family	全砖家居
brick fence	全砖围墙
brick fireplace	全砖墙炉
brick garage	全砖车库
brick home	全砖家居
brick house	全砖家居
brick masterpiece	全砖杰作
brick property	全砖家居
brick residence	全砖家居
brick townhouse	全砖排屋
brick two-bedroom	全砖两卧
brick unit	全砖公寓
brick units	全砖公寓
brick veneer	全砖贴面
brick villa	全砖别墅
bright bathroom	明亮浴室
broadband internet	宽频网络
budding location	潜质地区
building access	直入大楼
building facilities	建筑设施
building management	管理
building manager	管理
building manager-	管理
building security	管理
built ins	内置
built-in bedrooms	内置卧室
built-in dishwasher	内置洗碗机
builtin robes	内置衣柜
built-in robes	内置衣柜
built-in study	内置书房
built-ins	内置
burner cooktop	炉头
burner gas	炉气
bus access	临近公交
bus connections	临近公交
bus depots	临近公交
bus interchange	临近公交
bus links	临近公交
bus ride	巴士
bus routes	巴士路线
bus service	巴士服务
bus services	巴士服务
bus station	公交站
bus stations	公共汽车站
bus stop	公交站
bus stops	巴士站
bus terminus	巴士总站
bus transport	公交
bush backdrop	郊区背景
bush outlook	郊区美景
bush retreat	郊区小筑
bush setting	郊区地点
bush views	郊区美景
bushland backdrop	郊区背景
bushland reserve	丛林保护区
bushland surrounds	丛林包围
bushland views	丛林景色
bush-land views	丛林景色
bushland vistas	丛林景色
business districts	商业区
business hub	商业中心
business opportunities	商业潜力
business opportunity	商业潜力
business parks	商务园区
business potential	商业潜力
business premises	营业场所
butlers pantry	管家柜
buyer grant	首次买家资助
buyer groups	买家团
buyers opportunity	优质买家机缘
buying opportunity	优质买家机缘
buying option	买入期权
bygone era	古早年代
by-law conditions	法律条件
c.1904 refinement	c.1904年代修饰
cstone island	cstone台面
c1912 residence	c1912年代住宅
c1920s home	c1920s年代家居
c1940s hallmarks	c1940s年代标志
cabinet lighting	橱柜灯
cable internet	有线宽频
caesarstone benches	CaesarStone台面
caesarstone counter	CaesarStone台面
caesarstone island	CaesarStone台面
caesarstone waterfall	CaesarStone瀑布台面
cafes restaurants	咖啡馆餐厅
cage storage	仓储笼
high calibre finishes	高级修饰
call today	马上致电
capital growth	资本增长
captivating home	迷人家居
car access	汽车通道
car garage	车库
car garage*	车库
car garage•	车库
car garages	车库
car park	车库
car park-	车库
car park*	车库
car park2	车库
car parking	车库
car parking•security	车库
car parks	车库
car port	车棚
car space	车库
car space-	车库
car space*	车库
car space•	车库
car spaces	车库
car spaces.•	车库
car spaces•	车库
car spots	车位
car storage	车位
car tandem	并排车位
car wash	洗车
caravan storage	大篷车位
card entry	保险卡入口
carefree entertaining	轻松娱乐
carpet floors	地毯地板
carpets hallbedrooms	地毯厅卧室
carrara marble	carrara大理石
cash flow	资金流动
cast iron	铸铁
catchment area	校区
catchment area*	校区
catchment area•	校区
catchment areas-	校区
catchment zone	校区
catchment zones	校区
ceasarstone benches	ceasarstone台面
ceasor stone	ceasarstone台面
cedar stone	cedar石材
ceiling bi-folds	天花折门
ceiling fan	吊扇
ceiling fan*	吊扇
ceiling fan•	吊扇
ceiling fans	吊扇
ceiling fans*	吊扇
ceiling fans·	吊扇
ceiling fans•	吊扇
ceiling glass	天花板玻璃
ceiling heights	天花板高度
ceiling insulation	天花板保温
ceiling mirror	天花板镜子
ceiling porcelain	天花吸瓷
ceiling robes	天花板衣柜
ceiling robes*	天花板衣柜
ceiling roses	天花板玫瑰
ceiling rosettes	天花板花环
ceiling speakers	天花板音响
ceiling tiles	天花板瓷砖
ceiling tiling	天花板瓷砖
ceiling window	天花板窗口
ceiling windows	天花板窗户
ceilings fans	天花风扇
cellartasting room	酒窖品酒室
centralparkmore shopping	parkmore购物中心
centre shopping	购物中心
championship golf	高尔夫锦标赛
championship tennis	网球锦标赛
change room	更衣室
character charm	时代魅力
character elegance	时代魅力
character facade	魅力面墙
character home	个性家居
character homes	个性家居
character residence	个性家居
character weatherboard	个性家居
charming home	个性家居
chef’s kitchen	大厨厨房
chefs kitchen	大厨厨房
chicken coop	鸡窝
child care	托儿中心
childcare centre	托儿中心
childcare centres	托儿中心
children’s playground	儿童游乐场
children’s playroom	儿童游戏室
children’s retreat	儿童娱乐间
childrens playground	儿童游乐场
cinema room	电影室
dress circle address	优越地址
dress circle location	优越地址
circular driveway	圆形车道
citrus trees	柑橘树
city access	直达City
city apartment	市区公寓
city bus	市区公交
city buses	市区公交
city buses-	市区公交
city buses.-	市区公交
city centre	城市中心
city commute	市区公交
city commuters	市区公交
city development	城市开发区
city express	城市直通车
city fringe	都市边缘
city glimpses	都市美景
city landmark	都市地标
city life	都市生活
city lifestyle	都市生活方式
city lights	市区灯火
city living	大都市生活
city location	都市定位
city pad	都市公寓
city residence	都市家居
city skyline	都市天际线
city style	都市风格
city suburbs	都市小区
city trains	火车
city tram	有轨电车
city transport.-	都市交通
city view	都市景观
city views	都市景观
city views-	都市景观
cityscape views	都市景观
clad home	包家居
class finishes	精致修饰
class location	上等街区
class residents	上等街区
class restaurants	高级餐厅
class shopping	上等购物区
clerestory window	天窗
clever design	巧妙设计
clever floor	巧妙设计
clever pass	巧妙设计
clever use	巧妙设计
climate control	气候控制
clinker brick	熟料砖
closing drawers	关闭抽屉
clothes dryer	烘干机
clothes line	晾衣绳
club facilities	俱乐设施
club house	会所
club lounge	俱乐酒廊
coffee machine	咖啡机
coffee shop	咖啡店
colour bond	colourbond
colour palate	调色板色系
colour palette	调色板色系
colour palette-	调色板色系
colour scheme	色系
colour schemes	色系
colour tones	色系
combustion fire	炉火
combustion fireplaces	炉火壁炉
combustion wood	木材炉火
comfort lifestyle	舒适的生活方式
comfort living	舒适的生活
comfy bedrooms	舒适的卧室
communal facilities	公共设施
communal gardens	公共花园
community centre	社区中心
community centres	社区中心
community facilities	社区设施
community hall	社区会堂
community lounge	社区客厅
community pool	社区游泳池
community setting	社区环境
community village	社区小村
completion date	完成日期
completion mid	完成中
complex offers	小区提供
concept plans	概念图
concertina doors	折叠门
concierge service	礼宾服务
concrete island	混凝土岛台
concrete pillars	混凝土柱
connection bayonet	连接卡口
conservatory style	学院风格
considers comfort	舒适设计
construction downstairs	施工楼下
contact agent	联系中介
contemporary bathroom	时尚浴室
contemporary updates	时尚修饰
convenience store	便利店
convenience stores	便利店
convenient enclave	方便小区
convenient lifestyle	方便的生活方式
convenient living	方便生活
convenient location	方便地点
convenient pocket	方便小区
convenient setting	方便地点
convenient shopping	方便购物
convenient travel	方便出行
convenient walk	方便出行
conveys comfort	传达舒适生活
cook kitchen	厨房
cook top	炉灶口
cook top*	炉灶口
cooking appliances	烹饪器具
cooking facilities	烹饪设备
cooking facility	烹饪设备
cooking kitchen	厨房
cooking stainless	烹饪不锈钢
cooking stove	炉灶
cooler months	凉月期
cooling system	冷却系统
cooling upstairs	冷却楼上
corner allotment	角落佳位
corner apartments	角落的公寓
corner bath	角落浴
corner block	角落佳位
corner location	角落佳位
corner pantry	角柜
corner parcel	角落佳位
corner position	角落佳位
corner property	角落佳位
corner site	角落佳位
corner spa	角落温泉浴
corner windows	角窗
corner-crescents site	角落佳位
cosmopolitan buzz	都市生活
cosmopolitan lifestyle	都市生活
cottage gardens	村舍花园
cottage style	乡村风格
council facilities	会议设施
council rates	委员会率
country estate	国房地产
country feel	乡村风格
country living	乡村生活
country style	乡村风格
golf course views	高尔夫场美景
court location	小院位置
court residence	小院家居
court setting	小院位置
court yard	院子
courtyard access	小院的访问
courtyard apartment	小院公寓
courtyard area	小院面积
courtyard garden	小院花园
courtyard gardens*	小院花园
courtyard size	小院的大小
courtyard space	小院空间
courtyard	小院
cover alfresco	有盖阳台
cover balcony	有盖阳台
cover entertainment	有盖娱乐
cover outdoor	有盖户外区
cover parking	有盖车位
creature comforts	物质享受
crisp interiors	清爽内饰
crisp paint	清爽油漆
cross flow	通风
cross ventilation	通风
cubby house*	玩具房子
cul-de-sac close	胡同
cul-de-sac location	胡同位置
cul-de-sac setting	胡同设置
cupboard space	充裕橱柜
cupboard space*	充裕橱柜
cupboard space.•	充裕橱柜
cupboard space•	充裕橱柜
cupboard storage	充裕橱柜
custom cabinetry	定制橱柜
custom design	定制设计
custom designer	定制设计
custom joinery	定制设计
custom laundry	设计洗衣
custom updates	设计修饰
cute breakfast	可爱的早餐
cutting edge	前卫设计
cycle ac	循环空调
cycle ac*	循环空调
cycle air	循环空调
cycle air-conditioning	循环空调
cycle air-conditioning•plenty	循环空调
cycle cooling	循环冷却
cycle heating	循环暖气
cycle heatingair	循环暖气
cycle heatingcooling	循环空调
cycle split	循环空调
day care	托儿所
decent size	充裕
deck area	甲板面积
deck lights	甲板灯
deck overlooks	甲板俯瞰
deco bathroom	设计浴室
deco style	设计风格
defines luxury	豪华定义
delightful bedrooms	可爱的卧室
delonghi gas	delonghi气
deluxe bathrooms	豪华浴室
deluxe bedrooms	豪华卧室
deluxe kitchen	豪华厨房
demand area	高需地区
demand location	高需地区
demolition team	拆迁队
density development	密度发展
density residential	密度住宅
density zone	密度区
department stores	百货商店
depreciation allowances	折旧额
design bathroom	设计卫浴
design excellence	卓越设计
design home	设计家居
design magazine	设计杂志
design offers	设计提供了
design reveals	设计提供了
designer ambience	设计氛围
designer apartment	设计公寓
designer appointments	设计元素
designer bathrooms	设计浴室
designer elements	设计元素
designer ensuite	设计套房
designer ensuites	设计套房
designer finishes	设计元素
designer fittings	设计元素
designer home	设计家居
designer interiors	室内设计布局
designer kitchen	设计厨房
designer lighting	设计照明布局
designer living	设计式生活
designer quality	设计元素
designer renovation	设计元素
designer residence	设计家居
designer style	设计风格
designer touches	设计风格
designer townhouses	设计排屋
development opportunities	发展机遇
development opportunity	发展机遇
development options	发展潜力
development possibilities	发展潜力
development potential	发展潜力
development project	开发项目
development prospects	发展潜力
dine-in kitchen	方便厨房
dining area	饭厅
dining choices	饭厅选择
dining district	餐厅区
dining domain	餐厅区
dining options	餐厅区
dining room	饭厅
dining room*	饭厅
dining room•	饭厅
dining rooms	饭厅
dining rooms*	饭厅
dining space	饭厅
dining spaces	饭厅间
dining table	餐桌
diningmeals area	饭厅区
dinner parties	适晚宴
discerning buyer	精明买家
discrete study	隐秘书房
dishwasher +	洗碗机
display cabinets	展示柜
display home	展房
distinction awaits	特棒设计
district outlook	区景
district outlooks-	区景
district panorama	区景
district view	区景
district views	区景
district views-	区景
district views•	区景
district vistas	区景
don’t miss	万别错过
don’t wait	万别等待
door •	门
door access	门直达
door entrance	大门入口
door entry	大门入口
door entry•	大门入口
double lock	双锁
downstairs area	楼下的面积
downstairs bathroom	楼下浴室
downstairs bedrooms	楼下卧室
downstairs powder	楼下化妆间
downstairs rumpus	楼下娱乐区
downstairs space	楼下空间
downstairs study	楼下书房
downstairs toilet	楼下卫生间
dream come	梦想
dream family	梦想家居
dream garden	梦花园
dream home	梦想家居
dream home.this	梦想家居
dream kitchen	梦想厨房
dream lifestyle	梦寐以求的生活方式
dream location	梦寐以求的位置
dream luxury	梦寐以求的豪华
dream property	梦寐以求的家居
dream renovation	梦寐以求的设计
dress circle	上等街区
dressage arena	驯马场
dressing room	更衣室
dressing roomwir	更衣室
dressing table	梳妆台
drive way	车道
driveway access	车道
driveway entry	车道
driveway gates	车道闸
driveway parking	车道车位
dryer*security basement	烘干机*安全地下室
dual-vanity ensuite	双虚荣的套间
duplex development	排楼开发
duplex home	双拼房
duplex living	双拼生活
duplex site	双拼地点
duty concessions	税优惠
dwelling covenant	住宅约
dwelling house	住宅
easy-care garden	易打理花园
easycare investment	方便投资
easycare layout	方便布局
easycare lifestyle	方便生活方式
eat streets	食街
eat-in kitchen	方便厨房
education facilities	教育设施
efficient layout	有效布局
effortless entertaining	轻松娱乐区
effortless flow	轻松布局
effortless living	轻松布局
electricity bills	电费
electricity panels	电力板
electricity system	电力系统
elegant details	优雅细节
elevator access	电梯直达
elite schooling	精英校区
elite schools	精英校区
emergency call	紧急电话
en suite	套房
energy bills	高效节能
energy costs	高效节能
energy efficiency	高效节能
energy efficient	高效节能
energy rating	高效节能
enquire today	马上询问
ensuite bathrooms	套房浴室
ensuite master	主人套房
ensuite-plantation shutters	浴室百叶窗
entertain guests	方便待客
entertain outdoors	户外娱乐区
entertainers area	娱乐区
entertainers balcony	娱乐阳台
entertainers dream	方便待客
entertaining balcony	娱乐阳台
entertaining deck	娱乐阳台
entertaining options	娱乐空间
entertaining space	娱乐空间
entertaining spaces	娱乐空间
entertaining terrace	娱乐阳台
entertaining zones	娱乐区
entertainment area	娱乐区
entertainment area•	娱乐区
entertainment areas	娱乐区
entertainment balcony.-	娱乐阳台
entertainment complex	娱乐中心
entertainment deck	娱乐甲板区
entertainment facilities	娱乐设施
entertainment options	娱乐空间
entertainment patio	娱乐庭院
entertainment precinct	娱乐区
entertainment precinct.http	娱乐区
entertainment precincts	娱乐区
entertainment room	娱乐室
entertainment space	娱乐空间
entertainment system	娱乐系统
entertainment terrace	娱乐阳台
entertainment unit	音响
entertainment venue	娱乐场所
entertainment venues	娱乐场所
entrance doors	入口大门
entrance foyer	入口门厅
entrance gates	入口大门
entrance hall	入口大厅
entrance hall*	入口大厅
entry door	入口门厅
entry doors	入口门厅
entry foyer	入口门厅
entry gate	大门门口
entry hall	入口大厅
entry hallway	入扣走廊
entry level	初级
entry point	初级
entry points	初级
entry price	初入价格
entry vestibule	入口门廊
equipment kitchen	设备厨房
estate market	地产市场
evening meal	晚饭
everything cosmopolitan	大都市生活
everything location	方便位置
excellent opportunity	绝佳机缘
executive apartment	高管公寓
executive club	行政俱乐部
executive home	高管家居
executive lifestyle	高管生活方式
executive living	高管生活
executive residence	行政公寓
executive retreat	高管小区
executive study	高管书房
executive style	高管生活方式
executive townhouse	行政别墅
exhibition space	展览空间
exhilarating journey	愉快旅程
express bus	高速巴士
express buses	高速巴士
express train	特快列车
express transport	交通方便
extra-large lock	额外的大锁
exudes charm	散发魅力
exudes style	散发风格
facilities area	设施面积
facing apartment	向公寓
facing aspect	向面
facing balcony	向阳台
facing balcony*	向阳台
facing block	向块
facing corner	向角
facing home	向家居
facing patio	向天井
facing river	向河
facing terrace	向梯田
facing unit	向单位
family abode	家庭住所
family accommodation	家庭住宿
family ambience	家庭氛围
family appeal	吸引家庭
family area	家属区
family areas	家庭领域
family bathroom	家庭式浴室
family bathrooms	家庭式卫生间
family bedrooms	家庭式卧室
family buyers	家庭式购买者
family comfort	家庭式舒适
family comforts	家庭式舒适
family dining	家庭饭厅
family dinner	家庭饭厅
family dinners	家庭饭厅
family domain	家庭区
family dream	家庭式梦想
family enjoyment	家庭式享受
family entertainer	家庭式娱乐
family entertaining	家庭式娱乐
family entertainment	家庭娱乐区
family environment	家庭式环境
family estate	家族地产
family existence	家庭式
family flexibility	家庭式
family fun	家庭式
family gatherings	家庭式
family get-togethers	家庭式聚会
family guests	家庭式客人
family harmony	家庭式和谐
family haven	家庭式
family home	家居
family home*	家居
family homes	家庭式住宅
family hub	家庭式中心
family kitchen	家庭式厨房
family laundry	家庭式洗衣房
family life	家庭式生活
family lifestyle	家庭生活方式
family living	家庭式生活
family living-	家庭式生活
family locale	家庭式地点
family lounge	家庭休息室
family luxury	豪华家庭式
family mansion	豪府
family masterpiece	家庭式杰作
family meals	家庭式聚餐
family member	家庭成员
family members	家庭成员
family memories	家庭式
family needs	家庭需要
family neighbourhood	家庭式邻里
family oasis	家庭式绿洲
family paradise	家庭式天堂
family pet	宠物
family pets	宠物
family prestige	家族声望
family privacy	家庭式隐私
family property	家族房产
family residence	家庭式住宅
family retreat	家庭式娱乐间
family room	家庭室
family room-	家庭室
family room*	家庭室
family room•	家庭室
family rooms	家庭室
family rumpus	家庭室
family sanctuary	家庭式天堂
family size	家庭式规模
family space	家庭式空间
family spaces	家庭式空间
family streets	家庭式街道
family style	家庭式
family time	家庭时间
family zone	家庭室
family zones	家庭室
familydining room	饭厅
familymeals area	饭厅
familymeals room	饭厅
familyrumpus room	家庭娱乐室
familytv room	电视室
farmers market	农贸市场
feature brick	显有全砖
feature built-ins	显有衣柜
feature chandeliers	显有吊灯
feature designer	显有设计
feature ensuites	显有套房
feature fireplace	显有壁炉
feature island	显有岛式
feature lighting	显有灯效
feature master	显有主
feature wall	特色墙
feature walls	特色墙
features glass	显有玻璃
federation style	联邦式
feedtack sheds	饲料鸡舍
ferry wharf	渡轮码头
fibro tile	纤维瓦
fibrotile home	纤维家居
finer things	美好生活
fire heater	火坑
fire pit	火坑
fire place	火坑
fire place•	火坑
fire places	火坑
first-class casino	一流赌场
first-class facilities	一流设施
fitness centre	健身中心
five-bedroom home	五卧家居
five-burner gas	五燃烧器灶
flame fireplace	火坑
flawless design	完美布局
flawless finishes	完美布局
flawless layout	完美布局
flawless penthouse	完美阁楼
floating floor	浮动地板
floor access	楼直达
floor apartment	楼公寓
floor area	地板面积
floor board	地板
floor boards	地板
floor coverings	盖地板
floor heating	采暖地板
floor plan	平面图
floor plans	平面图
floor space	平面空间
floor studio	楼工作室
floor tiles	地砖
floor tiling	地砖
floor unit	楼公寓
floor units	楼公寓
flooring upstairs	楼上铺地
floorplan offers	平面图提供
flow ventilation	流动
flower corner	花瓶角
flowing design	流动布局
flowing floorplan	流动布局
flowing layout	流动布局
flowing spaces	流动布局
fluid layouts	流动布局
fly screens	飞帘
food markets	食品市场
food preparation	食物预备间
foot bath	足浴
foot ceilings	英尺高天花
foreshore parklands	滨公园
forever home	永久家居
four-bedroom home	四卧房
four-car garage	四辆车的车库
foyer entry	门厅入口
foyer meets	门厅接入
frameless rain	无框淋浴
frameless shower	无框淋浴
freestanding bath	独立式浴缸
freestanding brick	独立式砖
freestanding gas	独立式气
freestanding home	独立式家居
freestanding house	独立式家居
freestanding soaker	独立式透雨
freestanding stainless	独立式不锈钢
freeway access	高速公路入口
fridge cavity	冰箱空间
fridge space	冰箱空间
front balcony	前阳台
front bedroom	前卧室
front bedrooms	前卧室
front courtyard	前院
front deck	前甲板
front door	前门
front entrance	前门
front entry	前门
front fence	前篱
front garden	前花园
front gardens	前花园
front gate	大门
front gates	大门
front lawn*	前草坪
front lounge	前客厅
front patio	前天井
front porch	前廊
front rooms	前房间
front terrace	前阳台
front terrace*	前阳台
front unit	前公寓
front verandah	前面的阳台上
front wing	前翼
front yard	前院
frontage offers	正面提供
fruit plants	果树
fruit trees	果树
fruit trees-	果树
fuel heater	燃油暖炉
functionality purposes	功能布局
future development	未来开发潜力
future home	未来家居
future plans	未来计划
future rail	未来火车
future train	未来火车
gallery hub	画廊枢纽
gallery interiors	美馆式内部
galley kitchen	厨房
galley style	美馆式
game room	游戏室
games area	游戏区
games room	游戏室
garage 	车库
garage door	车库门
garage doors	车库门
garage facility	车库
garage roller	车库卷帘
garden allotment	园林配置
garden apartment	花园公寓
garden area	花园区
garden areas	花园区
garden aspect	园林面
garden bed	花坛
garden beds	花坛
garden block	花园地块
garden complete	园林配套
garden complex	园林配套
garden cottage	花园平房
garden courtyard	花园庭院
garden irrigation	园林灌溉
garden lighting	园林灯效
garden lovers	园艺爱好者
garden maintenance	园林养护
garden oasis	绿洲花园
garden outlook	绿荫美景
garden outlooks	绿荫美景
garden patio	花园庭院
garden pool	花园泳池
garden retreat	花园小区
garden sanctuary	花园式天堂
garden setting	花园小区
garden shed·	花棚
garden shed•	花棚
garden sheds	花棚
garden shedstroll	花棚
garden space	园林空间
garden spaces	园林空间
garden sprinkler	园艺喷头
garden storage	花园储物间
garden studio	花园工作室
garden surrounds	绿荫包围
garden terrace	花园露台
garden tools	园林工具
garden views-	花园的景色
garden vistas	花园的景色
gas appliances	燃气器具
gas appliances-	燃气器具
gas appliances*	燃气器具
gas barbecue	燃气烘烤器
gas bayonet	气刀
gas bayonets	气刀
gas bayonets-	气刀
gas bbq	燃气烧烤炉
gas burner	燃气燃烧器
gas cook	天然气做饭
gas cooker	燃气灶
gas cooker*	燃气灶
gas cooking	燃气灶
gas cooking-	燃气灶
gas cooking•	燃气灶
gas cooktop	燃气灶
gas cooktop-	燃气灶
gas cook-top	燃气灶
gas cooktop*	燃气灶
gas cooktopelectric	燃气灶
gas cooktop•	燃气灶
gas cooktops	燃气灶
gas facilities	燃气设施
gas fire	燃气壁炉
gas fireplace	燃气壁炉
gas fireplace-	燃气壁炉
gas fireplace*	燃气壁炉
gas fireplaces	燃气壁炉
gas fittings	燃气配件
gas flame	燃气壁炉
gas heater	燃气暖气
gas heating	燃气暖气
gas heating-	燃气暖气
gas heating*	燃气暖气
gas hotplates	燃气灶
gas kitchen	燃气灶
gas kitchen-	燃气灶
gas kitchen*	燃气灶
gas kitchenette	燃气灶
gas kitchens	燃气灶
gas log	燃气壁炉
gas outlet	天然气接口
gas outlets	天然气接口
gas point	天然气接口
gas points	天然气接口
gas range	燃气灶
gas stainless	天然气不锈钢
gas stove	煤气炉
gas stove-	煤气炉
gas stovetop	煤气炉
gas stovetop-	煤气炉
gas wall	气墙
gaswood combustion	气木燃烧
gate entry	入口
glass atrium	玻璃房
glass balustrade	玻璃栏杆
glass door	玻璃门
glass doors-	玻璃门
glass doors*	玻璃门
glass fencing	玻璃围栏
glass kitchen	玻璃厨房
glass louvres	玻璃百叶窗
glass roofed	玻璃屋顶
glass shower	玻璃淋浴间
glass splash	玻璃防溅板
glass splashback	玻璃防溅板
glass splashback*	玻璃防溅板
glass splashbacks	玻璃防溅板
glass splashbacks*led	玻璃防溅板
glass stacker	玻璃堆垛机
glass windows	玻璃窗
gloss cabinetry	光泽的橱柜
gloss cabinets	光泽的橱柜
golf club	高尔夫俱乐部
golf course	高尔夫球场
golf course.auction	高尔夫球场
golf courses	高尔夫球场
gourmet chef	大厨师
gourmet cooker	大厨锅
gourmet grocers	美食杂货店
gourmet kitchen*full	美食厨房
gourmet kitchens	美食厨房
gourmet style	美食式
government grants	政府拨款
government services	政府服务
grade floor	级地板
granite benches	花岗岩台面
granite benchtop	花岗岩台面
granite benchtops	花岗岩台面
granite stone	花岗岩
granny flat*	祖母房
granny flats	祖母房
grass courtyard*	草坪园
grass tennis	草地网球
grass yard	草坪园
grass yard*	草坪园
great potential	巨大的潜力
grocery shops	杂货店
grocery store	杂货店
grocery stores	杂货店
ground floor	地面
ground floor-	地面
ground level	地面
ground pool	地面游泳池
ground pool*	地面游泳池
ground salt	地盐
ground saltwater	地咸水
ground solar	地面太阳能
ground swimming	地面游泳池
growth area	潜力区
growth corridor	潜力走廊
growth location	潜力位置
growth potential	增长潜力
growth suburb	增长区
guest accommodation	客人住宿间
guest apartment	客房公寓
guest bathroom	客房浴室
guest bedroom	客人卧室
guest bedrooms	客人卧室
guest house	客人间
guest parking	客人车位
guest powder	客人化妆
guest room	客房
guest toilet	客房卫生间
guest toilet*	客房卫生间
guest unit	客房公寓
guest wc	客房卫生间
guests access	客人入口
gum flooring	胶地板
gum floors	胶地板
gum hardwood	胶硬木
gutter guards	天沟保护
gym facilities	健身房设施
gym room	健身房
hall way	大厅
harbour foreshore	海港
harbourfront parklands	海滨公园
harbourside apartment	海滨公寓
harbourside lifestyle	海滨生活
harbourside living	海滨生活
harbourside retreat	海滨小区
hardwood deck	硬木甲板
hardwood floorboards	硬木地板
hardwood flooring	硬木地板
hardwood floors	硬木地板
hardwood frames	硬木框架
hardwood plantation	硬木林
hardwood timber	硬木木材
health club	健康俱乐部
health clubs	健康俱乐部
hearts content	满足
heat pump	热泵
heat strips	热条
heater connection	加热器连接
heating point	加热点
heritage appeal	文物风格
heritage buildings	文物建筑
heritage style	传统风格
highlights quality	突出质量
high-quality design	高质设计
high-quality living	高质生活
highset home	高位家居
highway tram	公路电车
hinterland views	腹地美景
hip eateries	风格餐馆
hob cooktop	滚刀炉灶
hobby room	嗜好间
holiday letting	度假别墅
holiday retreat	度假别墅
home adjacent	家毗邻
home automation	家庭自动化
home boasts	家居拥有
home builders	房屋建筑商
home business	家庭办公室
home businessoffice	家庭办公室
home businesses	家庭办公室
home buyer	购房者
home buyers	购房者
home captures	家居拥有
home caters	家居提供
home chef	家庭厨师
home chefs	家庭厨师
home cinema	家庭影院
home circa	家居约
home combines	家居结合
home comprises	家居结合
home considers	家居结合
home consists	家居结合
home contains	家居结合
home defines	家居结合
home delivers	家居结合
home design	家居设计
home displays	家居结合
home embraces	家居结合
home excels	家居结合
home exudes	家居结合
home features	家居结合
home gym	家庭健身房
home impresses	家居结合
home include	家居结合
home include*	家居结合
home occupier	家住者
home occupiers	家住者
home offering	家居结合
home offers	家居结合
home office	家庭办公室
home office-	家庭办公室—
home office*	家庭办公室*
home owner	业主
home owners	业主
home ownership	业主
home package	家居结合
home presents	家居结合
home promises	家居结合
home redefines	家居定义
home remain	家居定义
home resonates	家居结合
home rests	家里位于
home reveals	家居结合
home showcases	家居展示
home showcasing	家居展示
home site	家居地区
home sits	家居地区
home spans	家居跨越
home study	家居书房
home style	住家方式
home suits	家居适合
home theatre	家庭影院
horse enthusiast	爱马者
horse stables	马厩
hospital precinct	医院区
hostess kitchen	女主厨房
hotel lobby	饭店大堂
hotel rooms	酒店客房
hotel services	酒店服务
hotel style	酒店风格
hotel suites	酒店套房
hour concierge	小时礼宾
hour security	小时保安
house features	房子结合
house lock	房子锁
house storage	房子储物间
house storage*	房子储物间
huge entertainers	巨大娱乐区
ideal easycare	方便打理
ideal location	理想地点
ideal opportunity	理想机会
ideal prospect	理想前景
ideal teen	理想的青少年
immaculate bathroom	完美浴室
immaculate gardens	完美花园
immaculate home	完美的家
immaculate interior	完美室内
immaculate levels	完美阶层
immaculate residence	完美家居
immaculate split	完美格局
improvements comprise	改进包括
inoutdoor layout	室内外布置
inoutdoor living	户外生活
income opportunity	收入潜力
income potential	收入潜力
income stream	收入潜力
income streams	收入潜力
indoor gas	室内燃气
indoor lap	室内游泳池
indoor living	室内的生活
indoor pool	室内游泳池
indooroutdoor design	室内外设计
indooroutdoor entertaining	室内室外娱乐区
indooroutdoor flow	室内室外流动布局
indooroutdoor layout	室内外布局
indooroutdoor lifestyle	室内室外生活方式
indooroutdoor living	室内室外生活方式
indooroutdoor living*	室内室外生活方式
induction cook	电磁炉
induction cooking	电磁炉
induction cooktop	电磁炉
induction cooktop-	电磁炉
induction cooktop*	电磁炉
induction kitchen	电磁厨房
infinity edge	无边泳池
infinity pool	无边泳池
information contact	信息请联系
information please	信息请联系
inground pool	地面游泳池
in-ground pool	地面游泳池
inground salt	地面盐游泳池
inground solar	地面太阳能
inground swimming	地面游泳
in-law accommodation	祖母房
inner west	内西
inner-city apartment	市中心公寓
inner-city home	市中心家居
inspect today	今天看房
inspection call	参观致电
inspection contact	参观致电
inspection day	看房日
inspection please	参观请
inspection times	参观
inspection today	今天参观
inspiring floorplan	漂亮布局
insurance levy	保险征收
intelligent design	智能设计
intercom entrance	对讲系统
intercom system	对讲系统
interest today	有兴趣马上
interior features	内部结合
interior finishes	室内装饰
interior layout	内部布局
investment andor	投资和
investment credentials	投资潜力
investment opportunity	投资潜力
investment option	投资潜力
investment options	投资潜力
investment portfolio	投资组合
investment potential	投资潜力
investment property	投资物业
investment property.some	投资物业
investment prospect	投资潜力
investment prospect-	投资潜力
investment purchase	投资买家
inviting bedrooms	漂亮卧室
inviting entrance	漂亮入口
inviting lounge	漂亮客厅
inviting spaces	极美空间
iron balustrade	铁栏杆
iron claw	铁爪
iron columns	铁栏
iron fireplaces	铸铁壁炉
iron lacework	铁花边
iron staircase	铁艺楼梯
ironbark flooring	铁皮木地板
irrigation system	灌溉系统
island bar	台面酒吧
island bench	岛台面
island bench-	岛台面
island bench*	岛台面
island benches	岛台面
island benchtop	岛台面
island breakfast	岛台面
island counter	岛台面
island gas	岛台天然气
island kitchen	岛台厨房
island stone	岛石台面
jarrah floors	贾拉地板
joint walls	连接墙
kauri pine	贝壳杉
kept secret	保密
kids retreat	孩子间
king bedrooms	特大卧室
king size	特大King
kitchen appliances	厨房电器
kitchen area	厨房面积
kitchen bench	厨房台面
kitchen boasts	厨房结合
kitchen combine	厨房结合
kitchen combines	厨房结合
kitchen dining	厨房饭厅
kitchen features	厨房结合
kitchen flooring	厨房地板
kitchen highlights	厨房结合
kitchen island	厨房岛台
kitchen layout	厨房布局
kitchen meals	厨房
kitchen offers	厨房结合
kitchen presents	厨房结合
kitchen splash	厨房防溅板
kitchen splash-back	厨房防溅板
kitchen splashbacks	厨房防溅板
kitchen w	厨房
kitchen*full size	厨房
kitchenmeals area	厨房用餐区
kitchenette downstairs	楼下小厨房
km drive	公里车程
kw solar	千瓦的太阳能
lagoon pool	礁湖泳池
land approx	土地约
land area	土地面积
land bank	土地存库
land banking	土地存库
land offering	土地结合
land offers	土地结合
land parcel	地块
land plan	土地规划
land size	土地规模
land value	土地价值
landmark building	地标建筑
lane access	双线接入
laneway setting	巷道设置
lap pool	游泳池
large walk	大走道
laundry facilities	洗衣设施
laundry facilities•	洗衣设施
laundry facility	洗衣设施
laundry room	洗衣房
laundry room-	洗衣房
laundry room*	洗衣房
laundry space	洗衣房
laundry*security intercom	洗衣房*保安对讲机
laundryutility room	洗衣房杂物间
lawn area	草坪面积
lawn areas	草坪区
lawn gardens	草坪花园
layout features	布局结合
layout offers	布局结合
layout reveals	布局结合
lead lights	铅灯
leadlight windows*	铅灯窗口
leafy address	绿荫地点
leafy backdrop	绿荫美景
leafy balcony	绿叶阳台
leafy enclave	绿叶小区
leafy gardens	茂密花园
leafy location	绿叶地区
leafy outlook	绿荫美景
leafy outlook•	绿荫美景
leafy outlooks	绿荫美景
leafy parks	葱郁公园
leafy pocket	绿叶小区
leafy setting	绿叶小区
leafy suburb	绿叶区
leafy surrounds	绿叶环绕
leafy trees	茂密树木
leafy views	绿荫美景
leafy vistas	绿荫美景
leisure facilities	休闲设施
leisure parks	休闲公园
leisure space	休闲空间
leisure spaces	休闲空间
length balcony	慷慨阳台
length glass	长身玻璃
length terrace	慷慨阳台
length windows	长身窗户
level >	水平>
level abode	水平住所
level access	水平通道
level allotment	水平地块
level apartment	高层公寓
level backyard	水平后院
level brick	水平砖
level building	高层建筑
level complex	水平建筑
level cottage	水平小屋
level design	水平设计
level duplex	水平双拼
level entertainer	水平娱乐间
level entry	水平入口
level family	水平家居
level features	层次结合
level floorplan	水平平面图
level front	水平前
level garden	水平园林
level gardens	水平园林
level home	水平家居
level land	一级水平土地
level landholding	水平土地
level lawn	水平草坪
level lawns	水平草坪
level lawns*	水平草坪
level layout	水平布局
level living	顶级生活
level lot	水平地段
level lounge	水平客厅
level parcel	水平地段
level penthouse	水平阁楼
level property	水平建筑
level residence	层住宅
level retreat	水平小区
level rumpus	水平娱乐间
level security	顶级保安
level semi	水平公寓
level site	水平地段
level stroll	毗邻
level studio	水平工作室
level study	水平书房
level terrace	水平阳台
level town	水平公寓
level townhouse	水平公寓
level unit	水平公寓
level villa	水平别墅
level villa•	水平别墅
level villas	水平别墅
level walk	水平步道
life style	生活方式
lifestyle address	生活首选区
lifestyle choice	生活首选区
lifestyle facilities	生活设施
lifestyle haven	生活首选区
lifestyle hub	生活首选区
lifestyle location	生活首选区
lifestyle opportunity	生活首选区
lifestyle options	生活首选区
lifestyle pad	生活首选区
lifestyle prospect	生活首选区
lifestyle seekers	生活首选区
lifetime opportunity	千载难逢的机会
lift access	电梯
lift access*	电梯
lift entry	电梯入口
light fittings	灯具
light fittings*	灯具
linen cupboard•	亚麻橱柜
linen cupboards	亚麻橱柜
linen press	亚麻布机
listing agent	代理
living area	生活区
living area*	生活区
living area•	生活区
living areas	生活区
living areas*	生活区
living areas•	生活区
living design	生活设计
living domains	生活领域
living environment	生活环境
living room	客厅
living rooms	起居室
living space	起居室
living spaces	起居室
living zone	起居室
living zones	起居室
livingdining room	起居室
livingdining rooms	起居室
location *	位置
location approx	位置约
location features	位置结合
location highlights	区位结合
location minutes	位置毗邻
location moments	位置毗邻
location offering	位置结合
lockup garage	锁车库
lock-up garage	锁车库
log fire	篝火
log fireplace	壁炉
lot size	地大
lot subdivision	能分割土地
lounge area	待客区
lounge areas	待客区
lounge room	客厅
lounge room*	客厅
lounge room•	客厅
lounge rooms	客厅
loungedining room	客厅
low-maintenance gardens	便利花园
low-maintenance lifestyle	便利生活
low-maintenance living	便利生活
lowset brick	低位全砖
lowset home	低位家居
luxury apartment	豪华公寓
luxury apartments	豪华公寓
luxury appointments	豪华结合
luxury bathroom	豪华浴室
luxury ensuite	豪华套间
luxury ensuites	豪华套房
luxury facilities	豪华设施
luxury features	豪华结合
luxury finishes	豪华的装饰
luxury home	豪宅
luxury homes	豪华住宅
luxury hotel	豪华酒店
luxury kitchen	豪华厨房
luxury lifestyle	奢华生活
luxury living	奢华生活
luxury residence	豪华住宅
luxury style	奢华风格
luxury waterfront	豪华海滨居
m frontage	米正面
m2 approx	平方米总
m2 block	平方米总
m2 total	平方米总
maintenance allotment	便利地块
maintenance backyard	便利后院
maintenance backyard-	便利后院
maintenance block	便利地块
maintenance courtyard	便利庭院
maintenance design	便利设计
maintenance environment	便利环境
maintenance family	便利家庭
maintenance garden	便利花园
maintenance gardens	便利花园
maintenance gardens-	便利花园
maintenance haven	便利天堂
maintenance home	便利家居
maintenance interiors	便利内饰
maintenance investment	便利投资
maintenance level	便利水平
maintenance lifestyle	便利生活
maintenance living	便利生活
maintenance option	便利选项
maintenance property	便利性能
maintenance rear	便利后
maintenance residence	便利住宅
maintenance retreat	便利小区
maintenance surrounds	便利周围
maintenance yard	便利后院
marble bathrooms	大理石浴室
marble fireplace	大理石壁炉
marble island	大理石岛台
marble kitchen	大理石厨房
market place	市场
master bathroom	主浴室
master bedroom	主卧室
master bedroom-	主卧室
master bedroom*	主卧室
master bedroom.-	主卧室
master bedrooms	主卧室
master chef	大厨
master ensuite	主人套房
master haven	主人间
master room	主卧室
master suite	主人套房
master suites	主人套房
masterpiece offers	杰作结合
mature hedges	成熟灌木
mature trees	成熟树木
meals area	餐区
meals areas	餐区
meals bar	餐区
meals zone	餐区
mealsfamily room	餐区
media room	媒体室
medium density	介质密度
meter frontage	平方米的临街面
metre frontage	平方米的临街面
metres frontage	平方米的临街面
min walk	分钟步行
minute drive	分钟车程
minute stroll	分钟直达
minute walk	分钟直达
minute’s walk	分钟直达
minutes’ drive	分钟直达
minutes’ walk	分钟直达
mirror built-in	镜子衣柜
mood lighting	气氛灯饰
morning coffee	早晨的咖啡
morning cup	早晨的咖啡
morning sun	朝阳
morning sun.some	朝阳
morning sunlight	朝阳
morning sunshine	朝阳
motorway access	高速公路通道
mountain views	山景
move straight	直搬入
movie theatre	电影院
multi-unit development	多公寓开发
music room	音乐室
nature reserve	自然保护区
nature trails	自然步道
neat bathrooms	整洁的浴室
need market	需要市场
night time	晚上时间
north aspect	北面
oak floorboards	橡木地板
offer today	今天开价
offering comfort	提供舒适
offers comfort	提供舒适
offers convenience	提供方便
offers peace	提供和平
offers plenty	慷慨提供
offers privacy	提供隐私
offers quality	提供质量
offers room	提供空间
offers space	提供空间
offers style	提供风格
office space	办公空间
off-street parking	街边车位
one-bedroom apartment	一卧公寓
onsite facilities	现场设施
opening lock	打开锁
open-plan kitchen	开放式厨房
open-plan layout	开放式布局
open-plan living	开放式布局
opportunity awaits	机会来临
opportunity knocks	机会来临
opportunity practices	机会来临
ornate ceiling	华丽的天花板
ornate cornices	华丽的飞檐
outdoor barbecue	户外烧烤
outdoor deck	户外甲板
outdoor domain	户外领域
outdoor entertaining	户外娱乐
outdoor flow	户外布局
outdoor kitchen	户外厨房
outdoor patio	户外庭院
outdoor pergola	室外凉棚
outdoor pools	室外游泳池
outdoor shower	户外淋浴
outdoor spaces	户外空间
outdoor terraces	室外露台
oversize bedrooms	超大卧室
owner builder	业主建筑师
owner home	业主家居
owner occupier	业主
owner occupiers	业主
pq approx	每季
pqwater rates	每季水费
panel lift	面板电梯
panel system	面板系统
pantry cupboard	厨房橱柜
pantry space	厨房空间
parents retreat	父母间
park land	公园
park lands	公园
park space	公园
park view	公园景色
park views	公园景色
parking area	停车位
parking bay	停车位
parking space	停车位
parking spaces	停车位
parking•security intercominspection	停车位
parkland views	公园景色
parkside setting	公园景色
parquetry floor	拼花地板
parquetry floors	拼花地板
patio area	庭院面积
patio perfect	庭院完美
pendant lighting	吊灯照明
penthouse apartment	阁楼公寓
pergola area	有盖区
period appeal	传统魅力
period character	传统魅力
period charm	传统魅力
period details	传统魅力
period elegance	传统魅力
period elements	传统魅力
period facade	传统魅力
period features	传统结合
period fireplaces	文物壁炉
period home	传统家居
period homes	传统家居
period residence	传统家居
period style	传统风格
phase power	三相电源
phone number	电话号码
photo identification	照片认证
picket fence	栅栏
picture rails	挂镜线
picture rails*	挂镜线
picture windows	图片窗口
picturesque garden	极美花园
pine floors	松木地板
plan apartment	布局公寓
plan area	布局区
plan design	布局设计
plan living	布局生活
plan lounge	布局客厅
plan meals	布局饭厅
play area	游戏区
play room	游戏室
please contact	请联系
plunge pool	消疲池
plus study	加书房
plush carpet	毛绒地毯
polyurethane gas	聚氨酯气
polyurethane kitchen	聚氨酯厨房
polyurethane kitchens	聚氨酯厨房
pool area	游泳池面积
pool bathroom	池浴室
pool house	游泳房
porcelain tiles	瓷质砖
potential development	发展潜力
powder room	化妆间
powder room-	化妆间
powder room*	化妆间
powder rooms	化妆间
power points	电源点
pq approx	每季约
premier development	顶级发展
premier schools	优越校区
premier walk	优越步道
premium finishes	卓越修饰
premium schools	优越校区
premium schools.no	优越校区
preparation bench	制备台
preparation space	制备空间
prestige development	优质开发
price bracket	价格档次
price guide	价格范围
price range	价格范围
pristine environment	纯净环境
privacy blinds	隐私百叶窗
privacy screens	屏风
property availability	家居能妥
property delivers	物业结合
property description	物业描述
property features	家居结合
property highlights	家居结合
property include	属性包括
property manager	物业管理
property market	房地产市场
property offers	物业结合
property portfolio	房地产投资组合
property presents	物业结合
property promises	物业结合
property sits	楼市位于
qtr approx	季约
qtr approx*	季约
quality apartment	优质公寓
quality appliances	优质家电
quality appliances*	优质家电
quality appointments	优质家居
quality bathroom	优质卫浴
quality bathrooms	优质浴室
quality block	优质地块
quality build	优质建筑
quality building	优质建筑
quality cabinetry	优质家具
quality carpet	优质地毯
quality carpets	优质地毯
quality design	质量设计
quality development	优质开发
quality extras	优质装置
quality family	优质家庭
quality features	优质结合
quality finishes	优质修饰
quality fittings	优质装置
quality fixtures	优质装置
quality floor	优质地板
quality flooring	优质地板
quality gas	优质天然气
quality home	优质家居
quality homes	优质家居
quality inclusions	优质装置
quality kitchens	优质厨房
quality lifestyle	品质生活
quality living	品质生活
quality materials	优质材料
quality primary	优质小学
quality property	优质家居
quality renovation	优质翻新
quality residences	品质住宅
quality schooling	优质校区
quality schools	优质校区
quality security	优质保安
quality stainless	优质不锈钢
quality stone	优质石材
quality tenant	优质租户
quality timber	优质木材
quality time	优质时间
quality townhouse	品质别墅
quality window	优质的窗口
quarter approx	季度约
quarter approx*	季度约
quarter approxcouncil	季度约
quarter approxwater	季度约
quarter council	季度约
quarterwater rates	季度约
queen bedrooms	大卧室
quiet location	安静位置
rc air	空调
rail station	火车站
rail transport	毗邻公交
railway station	火车站
rain shower	雨水淋浴
rain showers	雨水淋浴
rainwater shower	雨水淋浴
rainwater tank	雨水收集池
rainwater tanks	雨水收集池
range hood	抽油烟机
range hood•	抽油烟机•
ranking schools	排名学校
rat race	疲惫都市生活
rear aspect	后面
rear courtyard	后面院子
rear deck	后甲板
rear garden	后花园
rear gardens	后花园
rear neighbours	后邻居
rear sunroom	后阳光间
rear verandah	后阳台
rear yard	后园
reception rooms	接待室
recreation area	游乐区
recreation areas	游憩区
recreation facilities	娱乐设施
recreational facilities	娱乐设施
remote access	远程控制
remote control	远程控制
remote garage	遥控车库
remote-control garage	遥控车库
renovation project	翻新计划
rent returns-	租金回报
reserve backdrop	绿叶背景
residence boasts	住宅结合
residence delivers	住宅结合
residence displays	住宅结合
residence features	住宅结合
residence offers	住宅结合
residence presents	住宅结合
residence reveals	住宅结合
residence showcases	住宅结合
residence sits	住宅坐于
residence unfolds	住宅结合
residents access	居民通道
resort amenities	度假式设施
resort lifestyle	度假式生活
resort pool	度假式游泳池
restaurant precinct	餐食区
restaurant strip	餐食区
retreat area	休息区
retreat downstairs	楼下小区
return approx	回报率
return verandah	返回走廊
reverse air	反向空调
reverse-cycle air	反向空调
revitalisation project	翻新项目
ribbon address	蓝带地址
ribbon location	蓝带位置
river boardwalk	河木栈道
river frontage	河面
river views	河景
river walk	河滨步道
river walks	河滨步道
road access	通道
road frontage	路面
robe storage	衣柜
robed bedroom	衣柜卧室
robed bedrooms	衣柜卧室
roller blinds	卷帘
roller door	卷帘门
rooftop garden	屋顶花园
rooftop gardens	屋顶花园
rooftop terrace	屋顶露台
room offers	房间结合
round entertaining	圆型娱乐
rumpus area	娱乐区
rumpus room	娱乐室
rumpus room*	娱乐室
rumpusbilliard room	娱乐台球室
rumpusgames room	娱乐游戏室
sales office	销售办公室
saltwater pool	海水游泳池
sandstone alfresco	砂岩户外
sandstone features	砂岩结合
sandstone patio	砂岩阳台
sandstone terrace	砂岩阳台
sandstone terraces	砂岩阳台
sash windows	推拉窗
school bus	校车
school buses	校车
school catchments	校区
school zones	校区
school zoning	校区
schools shops	学校商店
seamless flow	流动布局
seamless transition	流动布局
secure alarm	保安警报
secure basement	保安地下室
secure block	保安地块
secure boutique	保安精品
secure building	保安建筑
secure car	保安车
secure complex	保安建筑
secure entry	保安门
secure gates	保安门
secure parking	保安车位
secure parking*	保安车位
secure side	保安边
secure storage	保安存储间
secure tandem	保安联排
secure video	保安视频
security alarm	保安报警
security apartment	保安公寓
security basement	保安地下室
security block	保安地块
security building	保安建筑
security building-	保安建筑
security building*	保安建筑
security cameras	保安摄像
security cameras-	保安摄像
security car	保安车位
security carspace	保安车位
security complex	保安复合体
security complex-	保安复合体
security door	保安门
security doors	保安门
security garage	保安车库
security garaging	保安车库
security gate	保安门
security intercom	保安对讲系统
security lift	保安电梯
security lock	保安锁具
security parking	保安车位
security parking*	保安车位
security screen	保安网
security screens	保安网
security shutters	保安门
security system	保安系统
security video	保安摄像
selling price	销售价格
servery window	备餐窗户
service lane	服务车道
service road	服务车道
shadow cornices	影子飞檐
shedwork shop	工作间
sheer size	庞大的
shopping centers	购物中心
shopping destinations	购物中心
shopping district	购物区
shopping facilities	购物区
shopping hub	购物中心
shopping options	购物中心
shopping precinct	购物区
shopping precincts	购物区
shopping strip	购物地带
shopping villages	购物村
shower bathroom	淋浴房
shower facilities	淋浴设施
shower head	淋浴头
shower room	淋浴房
shower screen	淋浴屏
shower screens	淋浴屏
side access	侧边通道
side balcony	侧阳台
side basement	侧基底
side garden	侧花园
side gate	侧门
site area	场地
site facilities	场地设施
site parking	场地车位
sitting room	客厅
size approx	大小约
skirting boards	踢脚板
skyline views	地平线
skylit kitchen	天窗厨房
slab floors	楼板
sliding doors	滑动门
soak bath	泡浴
soak tub	泡浴缸
soaker bath	浸泡浴
sound system	音响系统
spa bathroom	水疗浴室
spa ensuite	水疗套房
space heater	暖气机
speaker system	音响系统
speaker systems	音响系统
specialty shops	专卖店
specialty stores	专卖店
splash backs	防飞溅板
split air	分体式空调
split level	分错层
split system	分体式空调
split systems	分体式空调
sports facilities	体育设施
sports fields	运动场
sprinkler system	喷水系统
sqm approx	平方米约
sqm approx*	平方米约
sqm approx.	平方米约
sqm block	平方米地块
sqm block*	平方米地块
stacker doors	堆垛机门
stainless appliances	不锈钢器具
stainless gas	不锈钢气
stainless steel	不锈钢
stainless-steel appliances	不锈钢器具
stair access	楼梯通道
stair storage	楼梯创库
stamp duty	印花税
standing tenant	租客
standout address	绝佳地址
star energy	星节源
star resort	星级度假村
state schools	公立学校
steam room	蒸汽房
steel appliance	钢家电
steel appliances	钢家电
steel appliances-	钢家电
steel appliances*	钢家电
steel appliances·	钢家电
steel appliances•	钢家电
steel cooker	钢锅
steel cooking	钢锅
steel dishwasher	不锈钢洗碗机
steel kitchen	不锈钢厨房
stone bathrooms	石浴室
stone bench	石长台
stone bench*	石长台
stone benches	石长台
stone benchtop	石台式
stone bench-top	石长台
stone benchtops	石材台面
stone benchtops-	石材台面
stone bench-tops	石材台面
stone benchtops*	石材台面
stone benchtops.the	石材台面
stone breakfast	石材台面
stone finishes	石材饰面
stone finishes*	石材饰面
stone flooring	石材地板
stone floors	石材地板
stone kitchen	石厨房
stone surfaces	石材饰面
stone throw	毗邻
stone top	石顶
stone tops	石顶
stone tops*	石顶
stone vanity	石洗脸盆
stone’s throw	毗邻
stones throw	毗邻
storage •	存储区
storage area	存储区
storage areas	存储区
storage cage	仓储笼
storage cage*	仓储笼
storage cages	仓储笼
storage cupboard	存储柜
storage cupboards	存储柜
storage facility	存储区
storage options	存储区
storage room	储藏室
storage room*	储藏室
storage rooms	储藏室
storage shedwork	工作仓库
storage sheds	仓库
storage space	存储区
storage space*	存储区
storage spaces	存储区
storage unit	存储区
store room	储藏室
store room*	储藏室
storey home	层家居
storey residence	层家居
storey townhouse	层联排别墅
storey townhouses	层联排别墅
storey unit	层公寓
storm water	雨水
stove top	炉子
strata fees	管理费
strata levy	管理费
strata rate	管理费
street access	街头通道
street appeal	街区魅力
street frontage	临街面
street frontages	临街面
street level	街层
street parking	路边车位
street parking-	路边车位
street parking*	路边车位
street presence	雄伟家居
street setting	街区
street views	街景
striking bathrooms	漂亮浴室
student accommodation	学生住宿
students occupants	学生住宿
studio apartment	公寓
studio space	工作室
study apartment	书房公寓
study area	书房区
study downstairs	书房楼下
study home	书房家
study nook	书房区
study retreat	书房区
study room-	书房
study zone	书房区
study4th bedroom	书房第四居室
style residence	式住宅
sub penthouse	子阁楼
subdivision potential	分割潜力
summer barbeques	夏季烧烤
summer days	夏季
summer months	夏季
sun deck	阳光甲板
sun lit	采光
sun room	采光房
sunken lounge	客厅
sunny balcony	采光阳台
sunny kitchen	采光厨房
superb apartment	精湛公寓
superb choice	极佳选择
superb convenience	超级便利
superb home	高超家居
superb kitchen	精湛厨房
superb layout	高超布局
superb lifestyle	高超生活
superb living	高超生活
superb location	优越位置
superb opportunity	优越机会
superb property	卓越家居
superb residence	卓越住宅
superb setting	卓越布局
superb sun	卓越采光
surround sound	环绕声道
swimming pool	游泳池
swimming pools	游泳池
tandem car	串联车位
tandem garage	串联车库
tandem lock	串联锁
tandem lockup	串联闭锁
tax benefits	税收优惠
teenage retreat	青少年间
teenager retreat	青少年间
teenager’s retreat	青少年间
teenagers retreat	青少年间
temperature controlled•	温度控制
tenancy agreement	租赁协议
tennis court	网球场
tennis courts	网球场
term investment	长期投资
term lease	长期租赁
term tenant	长期租户
term tenants	长期租户
terrace access	平台通道
terrace area	阳台面积
terrace balcony	阳台
terrace basks	采光阳台
terrace home	阳台家居
terrace offers	阳台结合
terrace overlooks	阳台俯瞰
theatre room	剧院的房间
three-bedroom home	三间卧室的房子
thriving suburb	繁荣市区
tidy bathroom	简洁浴室
tidy bathrooms	简洁浴室
tidy gardens	简洁花园
tidy home	简洁家居
tidy interior	简洁布局
tidy kitchen	简洁厨房
tile flooring	瓷砖地板
tile home	铺砖家居
tiles downstairs	铺瓦楼下
timber beams	木梁
timber benchtops	木材台面
timber deck	木材甲板
timber decking	木材甲板
timber doors	木门
timber features	木材结合
timber floorboards	木地板
timber flooring	木地板
timber floorings	木地板
timber floors	木地板
timber floors*	木地板
timber fretwork	木细工
timber joinery	木材木工
timber kitchen	木材厨房
timber look	木材外观
timber shutters	百叶窗
timber staircase	木楼梯
timber style	木材风格
timber vanity	木材洗脸盆
time buyers	购房时间
timeless design	优雅设计
timeless elegance	优雅设计
title duplex	标题双拼
title home	标题家居
today’s market	今天的市场
toilet adjacent	厕所相邻
toilet downstairs-	楼下厕所
toilet downstairs•	楼下厕所
toilet facilities	卫生设施
tourism precinct	游客区
towel rail	毛巾架
towel rails	毛巾架
town home	联排房
town houses	联排房
town residence	联排房
town residences	联排房
town water	供水
townhouse development	别墅开发
townhouse offers	别墅结合
townhouse site	联排房地段
trades person	工人
traffic lights	交通灯
train services	公交
train stations	火车站
trains station	火车站
tram services	有轨电车
tranquil leafy	宁静绿叶
tranquil location	宁静位置
tranquil parkland	宁静公园
transport access	方便公交
transport hub	交通枢纽
transport interchange	方便公交
transport links	方便公交
transport options	方便公交
transport precinct	方便公交
transport services	方便公交
transportstrata levies	方便公交
travertine alfresco	钙华露天
travertine tiles	钙华砖
tv room	电视室
twin basins	双洗脸盆
two-bedroom apartment	两卧公寓
undercover alfresco	有盖娱乐区
undercover deck	有盖甲板区
undercover entertaining	有盖娱乐区
undercover parking	有盖车位
undercover patio	有盖娱乐区
undercover secure	有盖保安
undercover verandah	有盖阳台
underground parking	地下停车场
underhouse storage	房底储物间
unit complex	公寓小区
unit offers	公寓结合
unit presents	公寓结合
unit site	公寓地点
university campus	大学校园
upstairs bedroom	楼上卧室
upstairs bedrooms	楼上卧室
upstairs family	楼上家庭室
upstairs living	楼上家庭室
use rights	使用权
utility area	实用面积
utility room	实用间
vacuum aid	吸尘辅助
vacuum system	吸尘系统
valet vacuum	吸尘辅助
vanity ensuite	化妆套间
vantage point	优势景点
veggie patch	蔬菜小院
vehicle access	车道
vehicle accommodation	车辆住宿
versatile design	多功能布局
versatile floor	多功能地板
versatile floorplan	多功能布局
versatile layout	多功能布局
versatile living	多功能布局
vibrant restaurant	高客流餐厅
vibrant shopping	高客流购物
video intercom	可视对讲
video intercom*	可视对讲
villa home	别墅家居
villa style	别墅风格
villa unit	别墅公寓
village cafes	咖啡馆
village centre	小区中心
village life	乡村生活
village lifestyle	乡村生活
village location	乡村生活
village setting	乡村生活
village shops	小区购物
village shopscafes	"小区购物
咖啡馆"
visitor parking	访客车位
walk-in robe	步入式衣柜
walk-in wardrobe	步入式衣橱
walking distance	毗邻
walking tracks	步行道
walking trails	步行道
walkingbike tracks	步行自行车轨道
wall furnace	炉墙
wall heater	壁炉暖气
wall hung	挂墙
wall tiles	墙面砖
wall unit	墙公寓
warehouse conversion	仓库翻新
water feature	景观水饰
water features	景观水饰
water front	水滨
water frontage	面正水滨
water glimpses	水景
water pool	水池
water promenade-	水滨步道
water storage	储水
water system	雨水系统
water systems	雨水系统
water tank	雨水水箱
water tank-	雨水水箱
water tank•	雨水水箱
water tanks	雨水水箱
water view	水观
water views	水观
waterfall edge	瀑布边
waterfall island	瀑布岛台
waterfall stone	瀑布石台
waterfront block	滨水街区
waterfront home	海滨家居
waterfront parks	滨水公园
waterfront reserve	滨水公园
waterfront residence	滨水住宅
watering system	洒水系统
waterside locale	滨水街区
waterside parks	滨水公园
weatherboard home	护墙家居
week approx	周约
weekend brunches	周末早茶
weekend get-togethers	周末约会
welcoming home	欢迎回家
wet bar	酒吧
width alfresco	慷慨露天
width balcony	慷慨阳台
window coverings	窗帘
window furnishings	橱窗摆设
window seat	靠窗座位
window seats	靠窗座位
window sills	窗台
wine bars	酒吧
wine cellar	酒窖
wine fridge	葡萄酒冰箱
wine rack	酒架
winning architects	获奖建筑师
winter garden	冬季花园
winter months	冬季
winter nights	冬晚
winter sunshine	冬天采光
wood fire	木火
wood fireplace	木壁炉
wood heater	木壁炉
wood timber	木材
wool carpet	羊毛地毯
work bench	工作台
work shop	工作间
work space	工作间
works fund	工程基金
workshop area	工作间
workshopstorage area	工作间
world charm	都市魅力
world city	世界都市
world class	世界顶级
wraparound bench	概括台面
wraparound courtyard	环绕式庭院
wraparound terrace	环绕式阳台
wraparound terraces	环绕式阳台
wraparound verandah	环绕式阳台
wrought iron	铁艺
x split	X分
yard space	后院
year lease	年租
year round	全年的
yielding investment	投资收益
york style	纽约风格
first home buyer	首次买家
opportunity of a lifetime	千载机缘
exclusive pocket	优质小区
well maintained	优质
well-maintained	优质
elevated views	高边景观
top floor	顶层
light flooded	采光
opens onto	开往
opens to	开往
development site	开发地段
meters from	毗邻
metres from	毗邻
walk to	毗邻
close to	毗邻
moments to	毗邻
moments away from	毗邻
it's footsteps	毗邻
it is footsteps	毗邻
for years to come	#
walk to everywhere	极为便捷
set in 	设在
towel ladder	毛巾架
scope to add	能加
vast choice	极多
appointed with	结合了
prestige complex	优等建筑
Be a part	置身与
bench top	台面
complete with	结合了
walk-to-everywhere	极为便捷
meters to	毗邻
metres to	毗邻
a stroll	輕鬆步至
painted	刷漆
carpeted	地毯
outdoor access	戶外通道
in the heart of	核心
recently renovated	最近翻新
mirrored	mirror
security	保安
inspect	参观
renovated	翻新
renewal	翻新
dining	饭厅
overlooking	俯瞰
executive	高管
pristine	高级
terrace	公寓
rear	后面
trains	火车
property	家居
retreat	间
complex	建筑
gym	健身房
stunning	惊艳
outlook	景观
living	客厅
levels	楼层
aspect	面向
title	所有权
sanctuary	天堂般
idyllic	天堂般
touches	修饰
prestige	优等
premier	优质
entertainer	娱乐
entertainers	娱乐
access	直通
master	主人房
