full brick	全砖
full-brick	全砖
first time offer	首次出售																		
Handy Location	便利位置	便捷位置	非常便捷	位置便利	位置便捷														
Handy Position	便利位置	便捷位置	非常便捷	位置便利	位置便捷														
convenient location	便利位置	便捷位置	非常便捷	位置便利	位置便捷														
convenient position	便利位置	便捷位置	非常便捷	位置便利	位置便捷
light filled	采光好的
light-filled	采光好的
perfect location	優越位置	上佳地段	完美地段	高尚地段	卓越地段	完美佳位	首選佳位												
prime location	優越位置	上佳地段	完美地段	高尚地段	卓越地段	完美佳位	首選佳位
family entertainer	 家庭娱乐室
executive living 	時尚生活
executive home	時尚生活																		
close to station	近车站																		
proximity to station	近车站																		
walkable to station	近车站																		
walk to station	近车站																		
fully furnished	家具齐全																		
fuly-furnished	家具齐全																		
granny flat	祖母房																		
deposit taken
brand new	全新																		
bathroom    卫生间
open plan	開放式空間
low maintenance	易打理
easy access	轻松直通
high ceilings	高天花
main bathroom	主浴室 
stainless steel	不锈钢 
internal laundry	内部洗衣房
natural light	天然采光 
short walk	輕鬆步达
first home	第一家 
formal lounge	正統客廳
internal access	内部直通
built-in robes	内置衣櫃
public transport	方便公交
walk-in robe	步入衣柜
double garage	双车库 
large bedrooms	宽敞卧室 
lock-up garage	锁车库 
full brick	全砖建设
modern kitchen	现代厨房
spacious bedrooms	宽敞卧室
single level	单独楼层
local shops	当地商店
short stroll	輕鬆步至
close proximity	便捷位置
separate toilet	独立卫生间
double brick	双砖建设
top floor	最高楼层
double bedrooms	双卧室 
generous bedrooms	宽大卧室
rare opportunity	难得机会
evaporative cooling	蒸发空调
main bedroom	主卧室 
local schools	临近学校
quiet street	安静街道
high side	高边街区
ample storage	充足存储
short drive	车程便捷
reverse cycle	循环空调 
built-in wardrobes	内置衣柜
entertaining area	娱乐区 
separate bath	独立浴缸
first time	首次
good size	宽大慷慨
new home	新家 
separate dining	独立饭厅
upper level	上层 
double carport	双车库 
hot water	热水 
high quality	高质 
ducted heating	管道暖气
french doors	法式大门 
formal dining	正规饭厅
central bathroom	中央浴室
spacious living	宽敞客厅
separate shower	独立淋浴间
easy care	易护理 
large family	大家庭 
first floor	一楼 
polished timber	抛光木版
rear garden	后花园 
own enquiries	自己查询
casual living	休闲生活
alfresco area	露天区域 
private balcony	私人阳台
separate lounge	独立家庭室
great opportunity	绝佳机会
private schools	私立学校
formal living	家庭生活区
separate laundry	独立洗衣
separate living	独立生活区
young families	年轻家庭
spacious lounge	宽敞生活区
easy walk	容易步达
modern bathroom	现代浴室
multiple living	多生活区 
private courtyard	私家庭院
easy reach	容易到达
full bathroom	完整浴室
walk-in wardrobe	步入式衣橱
perfect place	完美地段
informal living	休闲生活区
new carpet	崭新地毯 
quiet cul-de-sac	安静胡同 
solar panels	太阳能电板
direct access	直接通达
prime location	优越位置
european appliances	欧式家电
other features	其他优点
spacious family	宽敞家庭
rear yard	后方花园
spa bath	温泉卫浴
granite bench	花岗岩坪
in-ground pool	坐地游泳池
lift access	电梯直通
full ensuite	全套房 
contemporary style	摩登风格
open fireplace	开放火炉
convenient location	便捷位置
total area	总面积 
bi-fold doors	双折门 
fantastic opportunity	绝佳机会
generous proportions	慷慨比例
interested parties	有兴趣人士
double lock	双锁
dual level	双层
few minutes	数分钟 
generous size	空间慷慨
contemporary living	优雅生活
large living	宽敞生活区
walk-in pantry	茶水间 
new kitchen	崭新厨房
north aspect	受欢迎之北向
outdoor living	户外生活
easy stroll	轻松漫步
following tabs	下面标签
other websites	其他网站
single lock	单锁 
high end	高端 
rental return	租金回报
great location	优越位置
off-street parking	街边车位
secondary schools	中学 
spacious kitchen	宽敞厨房
generous living	慷慨生活区
built-in wardrobe	内置衣柜
main living	主要生活区
modern bathrooms	现代浴室
real estate	房地产 
astute investor	精明投资者
leafy outlook	绿荫景观
primary school	小学
rental income	租金收入
single garage	单车库 
modern apartment	现代公寓
north facing	北向
panoramic views	全景 
prospective purchasers	准买家 
side access	侧门通达
exciting opportunity	绝佳机缘
great investment	绝佳投资
modern living	现代生活区
open living	开放生活区
open-plan living	开放式生活区
casual meals	休闲餐室
central location	中央位置
dining room	餐厅 
large laundry	大型洗衣间
modern family	现代家庭区
neutral tones	和谐色调
built-in robe	内置衣柜
eat-in kitchen	方便厨房
excellent opportunity	上佳机会
large storage	宽敞存储量
new family	新家庭
outdoor entertaining	户外娱乐
granite benchtops	花岗岩台面
quiet location	安静位置
remote garage	遥控车库
additional bedrooms	额外卧室
internal entry	内部入口
living area	生活区 
private ensuite	私人套房
catchment area	学区
large master	大主卧
local buses	临近公车
single carport	独立车库 
well-appointed kitchen	全设备厨房
built ins	内置存储
contemporary design	时代设计
elevated position	高边位置
front door	前门 
northerly aspect	面北方向
separate family	单独家庭区
short distance	短距离 
solid brick	实砖建设 
stylish bathroom	时尚浴室
walk-in robes	步入式衣柜
additional features	附加优点
ideal investment	理想投资之选
outdoor area	室外区域
tree-lined street	绿树成荫街
bench space	长凳空间
cupboard space	橱柜空间
dual living	双重生活
internal laundry-	内部洗衣房
local amenities	本地设施
major shopping	购物天堂
modern ensuite	现代套房
young family	年轻家庭
ample cupboard	充足橱柜
attic storage	阁楼存储
double storey	双层 
first homebuyers	首次购房者
sought-after location	抢手位置
spacious interiors	宽敞内部
spacious master	宽敞主卧
casual dining	休闲餐饮
contemporary kitchen	现代厨房
large lounge	寬敞客廳
light-filled living	采光生活区
private garden	私家花园
solid timber	实木 
astute investors	精明投资者
extra storage	额外存储空间
primary schools	小学 
rear access	背后直通
second bedroom	次卧室 
stainless-steel appliances	不锈钢器具
contemporary home	当代家居
excellent storage	优良贮存
large kitchen	大厨房 
large windows	大窗户 
long term	长期 
separate powder	独立卫浴
top quality	一流质量
central kitchen	中央厨房
excellent schools	优秀学校
floor-to-ceiling tiles	鋪磚墻面
local cafes	本地咖啡馆
modern home	现代家居
new apartment	新公寓
stainless appliances	不锈钢器具
beautiful home	美丽家园
contemporary interiors	高档设计
covered alfresco	有蓋露天區
european laundry	欧式洗衣房
large balcony	大阳台 
light rail	轻轨 
popular schools	优秀学校
whole family	全家人 
wide frontage	宽敞街面
dual street	双街面 
easy living	简单生活
exceptional family	优秀家庭
fresh paint	崭新油漆
further details	进一步细节
outstanding opportunity	优秀机会
perfect family	完美家庭
perfect opportunity	完美机会
relaxed family	轻松家庭
unbeatable location	绝佳位置
californian bungalow	加州平房
double vanity	双洗盆
front garden	前园
landscaped gardens	绿荫花园
large bedroom	大卧室 
new luxury	崭新豪华
remote control	远程控制
second toilet	次卫浴 
ample space	充足空间
blank canvas	创作白稿
blue ribbon	蓝带 
expansive living	广阔生活
internal laundry*	内部洗衣房
local shopping	本地购物
neutral colour	和谐色调
ornate ceilings	华丽天花
other amenities	其他设施
premium location	优越地理
separate wc	独立卫生间
comfortable family	舒适家庭
comfortable living	舒适生活
easy maintenance	易于维护
ensuite bathroom	卫浴间 
entertaining spaces	娱乐空间
further information	进一步信息
high ornate	高档华丽 
local eateries	本地餐馆
modern finishes	现代修饰
open fire	开放火炉
original condition	古早状态
original kitchen	古早厨房
polished floorboards	打磨地板
public schools	公立学校
separate study	独立書房
single car	单辆车 
spacious layout	宽敞布局
spectacular views	壮观景色
square metres	平方米 
additional robed	额外衣柜
bright interiors	明亮室内
common wall	共用墻
convenient position	位置便利
exceptional opportunity	特殊机会
full length	全长 
huge backyard	巨大后院
ideal opportunity	理想机会
large families	大家庭 
local parks	邻近公园
modern appliances	现代家电
modern interiors	现代室内设计
remote-control garage	遥控车库
second bathroom	第二浴室
spacious bedroom	宽敞卧室
stylish kitchen	时尚厨房
tasmanian oak	塔斯马尼亚橡木
tiled floors	鋪磚地板
wonderful opportunity	极好机会
built-in storage	内置存储间
cathedral ceilings	大教堂天花
contemporary family	美丽家庭
double size	两倍大小
dual occupancy	双双入住 
express city	都市快车
further highlights	更显得
granite kitchen	花岗岩厨房
large backyard	大后院
level lawn	水平草坪
lifestyle opportunity	优秀生活
perfect home	完美家居
rapid access	快速直通
separate storage	单独存储间
slow combustion	慢燃
stunning home	驚艷家居
sunny balcony	采光阳台
third bedroom	第三卧室
wet bar	酒吧 
central family	核心家庭
covered entertainment	有蓋娱乐區
east aspect	面东方向
external access	外部直通
fantastic property	出色地段
flexible floorplan	灵活布局
full size	全面大小
good-sized bedrooms	大卧室 
ideal place	理想地方
inner city	城市内部
local bus	邻近公交
modern updates	现代修饰
open-plan kitchen	开放式厨房
quick access	快速直通
quiet tree	安静树荫
recreational facilities	娱乐设施
separate w/c	独立卫浴
small complex	小区
solar power	太阳能
updated bathroom	以裝修浴室
abundant storage	丰富存储间
additional parking	额外车位
additional storage	额外存储室
central heating	中央暖气
contemporary apartment	時尚公寓
covered balcony	有蓋阳台
covered outdoor	有蓋露天區
dining area	餐饮区 
double bedroom	双卧室 
double doors	双扇门 
double remote	双遥控 
en suite	套房 
fourth bedroom	第四卧室
functional kitchen	功能齐全厨房
generous lounge	慷慨休息室
large bathroom	大浴室 
large study	大书房
new carpets	新地毯 
open lounge	开放式客廳
other bedrooms	另一卧室
quiet cul	安静小路
second living	第二生活区
single storey	单层 
unique opportunity	独特机会
wide driveway	宽阔车道
automatic garage	自动车库
central hallway	中央走廊
child-friendly level	適合兒童区
decorative ceilings	漂亮天花板
door step	门口台阶
great home	漂亮住宅
indoor/outdoor living	室内/室外生活区
large pantry	大厨房 
other highlights	其他优点
seamless indoor/outdoor	天衣无缝户内/户外
spacious apartment	宽敞公寓
stunning views	迷人景色
ultimate convenience	位置便利
ample bench	充足桌面
corporate fees	物业费
east facing	面东方向
easy commute	简易通勤
future development	未来发展
hard work	艰苦工作
in-ground swimming	入地游泳池
large block	大地段
leafy views	绿荫景色
lifestyle appeal	简易生活
north-east facing	面东北方向
outdoor awnings	有盖户外
outdoor kitchen	户外厨房
outstanding location	優越地段
own investigations	自己调查
rental returns	優越租金回报
undercover alfresco	露天室外区
unique property	独特地段
well-proportioned bedrooms	匀称卧室
added bonus	附加优点
beautiful family	美丽家庭
contemporary comfort	现代舒适
east side	东区 
entertaining deck	甲板娱乐区
gorgeous timber	华丽木材
grand scale	盛大规模
granny flat	祖母公寓
high ceiling	高天花
high schools	高中 
huge living	巨大生活区
internal living	内部生活区
leafy surrounds	绿叶环绕
metre frontage	平方米向街面
modern design	现代设计
new residence	全新住所
outdoor entertainment	户外娱乐区
perfect blend	完美融合
prestigious schools	名校林立
prime position	绝佳位置
rear lane	尾巷 
salt water	盐水 
savvy investor	精明投资者
second floor	二楼 
several cars	几辆汽车
ample room	充足房间
balcony access	阳台直通
built-in robes-	内置衣柜
cul-de-sac location	胡同位置
double shower	双淋浴 
elite schools	精英学校
european style	欧式风格
extended family	大家庭 
extra features	额外特点
flexible floor	弹性地板
future potential	潜利 
generous floor	宽大楼层
heated pool	温水游泳池
high demand	高需
high gloss	抛光
internal lift	内部电梯
local parklands	邻近公园
modern style	现代风格
natural sunlight	自然阳光
new owner	新主人 
open design	开放式设计
open kitchen	开放式厨房
original features	古早特征
original timber	原木材 
outdoor space	户外空间
peaceful street	安静街道 
polished floors	抛光地板
premium finishes	高等修饰
private backyard	私人后院
private gardens	私家园林
rare find	罕见
rare offering	罕见
ultra-convenient location	便捷位置
big bedrooms	大卧室 
close drawers	关闭抽屉
contemporary residence	当代住宅
covered deck	有蓋甲板
current owners	目前业主
decorative cornices	飞檐装饰
desirable location	理想位置
dual access	双双直通
electric oven	电烤箱 
excellent condition	良好条件
exceptional home	特殊家
floor-to-ceiling glass	落地玻璃
full width	全宽度 
generous layout	慷慨布局
great place	优等地段
great storage	优等储存间
indoor pool	室内游泳池
lifestyle excellence	卓越生活方式
living room	客厅 
lock-up storage	带锁存储
low rise	低层 
low strata	低物业费
luxurious comfort	豪华舒适
luxurious master	豪华主人房
manicured gardens	漂亮花园
multi-purpose room	多功能空间
next door	隔壁 
northern sun	面北太阳
ocean views	漂亮海景 
open floor	开放式
open space	开放空间
original bathroom	古早浴室
own driveway	自己车道
popular cafes	受欢迎咖啡
popular eateries	受欢迎餐馆
popular location	热门地点
public school	公立学校
rear courtyard	后院
relaxed living	轻松生活
remote door	遥控门 
sqm block	平方米块
storey residence	层住宅 
stylish interiors	时尚内饰
tropical gardens	热带花园
underfloor heating	采暖地板
updated kitchen	新修厨房
versatile floor	多功能布局
alfresco terrace	露天阳台
american oak	美国橡木
arterial roads	交通便捷
built-in robes*	内置衣柜
central living	中央生活
circular driveway	圆形车道
ducted air	管道空调
duplex site	duplex区
easy flow	舒服易通 
entertaining space	娱乐空间
fantastic home	梦幻般家
flexible living	灵活生活
foreign investment	外国投资
formal lounge/dining	正规客厅
full advantage	充分利用
garden views	花园景色
generous family	慷慨家庭区
great family	漂亮家庭
great features	华丽特点
great size	慷慨尺寸 
huge family	庞大家庭区
idyllic lifestyle	田园诗般生活
large level	慷慨楼层
light-filled lounge	采光客厅
long day	疲惫一天
new homes	新家园
new owners	新主人 
northern aspect	面北方向 
private entrance	私人入口
small block	小地段
solar system	太阳能系统
spacious balcony	宽敞阳台
spacious home	宽敞家区
under-house storage	地库储存间
wonderful family	美好家庭
advertised time	广告时间
alfresco deck	露天甲板
amazing opportunity	惊人机会
balcony- modern	阳台-现代
bright living	美好生活
classic home	经典家居
combined living	结合生活
common walls	共用墻
cupboard storage	橱柜储存
double car	双车库
dual vanity	双洗盆
everyday living	每天生活
excellent investment	优良投资
extra toilet	额外卫浴
fantastic investment	出色投资
fantastic location	极好位置
first class	头等
frameless shower	无框淋浴
frequent city	频繁城市
further bedrooms	更多卧室
generous master	慷慨主人房
golden opportunity	千载难逢机
good storage	良好储存
great property	漂亮地段
immaculate condition	完美条件
large feature	慷慨特点
leadlight windows	雕花灯窗
leafy outlooks	叶观美景
light stream	采光
light-filled interiors	采光内部
local primary	邻近小学
l-shaped lounge	L形客厅
new timber	新木材
open study	开放性书房
oversized bedrooms	超大卧室
private alfresco	私人户外区
private entry	私人入口
quiet court	安静庭院
rear deck	后面甲板活动区
relaxed lifestyle	轻松生活方式
savvy investors	精明投资者
second level	二楼层
sleek kitchen	时尚厨房
solar electricity	太阳能
stunning family	惊人家庭区
sunny north	采光面北
sweeping views	一览无余
ultimate family	顶级家庭区
undercover car	有盖车位
underhouse storage	地库储存间
well-equipped kitchen	设备齐全厨房
wide range	多选择
additional living	额外生活区
beautiful timber	上佳木材
built-in bbq	内置烧烤炉
combined lounge	结合客厅
contemporary renovation	时尚装修
cul-de-sac setting	胡同地段
double tandem	双车位
enormous potential	巨大潜力
entertaining terrace	娱乐区 
enviable lifestyle	令人羡慕生活
full height	全高 
further capitalise	进一步利用
house-like proportions	房子一样比例
intercom entry	对讲机入境
interior design	室内设计
large breakfast	大早餐区
large rumpus	大型娱乐区
lifestyle location	生活方式定位
light fittings	灯具 
luxurious living	奢华生活
main road	主要道路
many years	许多年 
modern comfort	现代舒适
modern gas	现代煤气家具
neat bathroom	整洁浴室
new paint	崭新油漆
open layout	开放式布局
outstanding family	优秀家庭区
perfect investment	完美投资
perfect location	完美位置
perfect spot	完美地段
private retreat	私人书房
quick drive	位置便利
quiet position	安静位置
rental demand	租赁高需
separate studio	独立工作室
solar panel	太阳能
stylish apartment	时尚公寓
tiled bathroom	瓷砖浴室
top level	顶层 
ultra convenient	超方便 
wide street	宽阔大街面
additional car	额外车位
affordable price	实惠价格
architectural design	建筑设计
architectural masterpiece	建筑杰作
contemporary finishes	时尚装修
contemporary lifestyle	现代生活方式
double door	双式门 
endless potential	无穷潜力
entertaining areas	娱乐区 
exceptional lifestyle	独特生活方式
fifth bedroom	第五卧室
flexible layout	灵活布局
floor-to-ceiling windows	落地窗 
front yard	前院 
full bathrooms	完整浴室
good quality	高质量
great layout	优质布局
green spaces	绿色空间
high ceilings-	高天花板
ideal home	理想家居
ideal location	理想位置
internal access-	内部直通
lane access	小巷直通
large island	宽敞厨房桌
level access	直通
luxurious family	豪华家庭区
magnificent views	壮丽景色
many features	多功能
marble kitchen	大理石厨房
neat kitchen	整洁厨房
new bathroom	新浴室
new benchmark	新基准
other local	其他地方
outdoor pool	室外游泳池
paved courtyard	铺就庭院
peaceful location	安静位置
peaceful setting	安静环境
private access	私人直通
private home	私人住宅
private terrace	私人露台
prized location	珍贵地段
renovated kitchen	装修厨房
s/s appliances	s／s家电
separate bathroom	独立浴室
separate entrance	单独入口
separate kitchen	独立厨房
sought-after street	抢手街区
spacious residence	宽敞住宅
strong growth	强劲增长
sunny aspect	采光面向
super convenient	超级方便
timber floors	木地板 
total land	土地总 
additional highlights	其他亮点
aquatic centre	水运中心
beautiful garden	美丽花园
cathedral ceiling	大教堂天花版
cheerful kitchen	优良布局厨房
complete privacy	完全隐私
contemporary bathroom	时尚浴室
contemporary sophistication	时尚装修
convenient access	方便直达
convenient lifestyle	方便生活方式
deluxe ensuite	豪华套间
desirable floor	理想地板
double glazing	双层玻璃窗
double sink	双水槽 
electric cooking	电灶
enviable location	羡慕地段
european oak	欧式橡木
excellent location	优越地位
exclusive listing	独家上市
external laundry	外部洗衣房
extra parking	额外停车场
fantastic family	梦幻般家庭
floor-to-ceiling tiles-	鋪磚墻面
following features	以下功能
free-standing bath	独立式浴缸
full bath	全身浴 
granite benches	花岗岩长凳
great condition	优越精整
handy location	方便位置
high level	高楼层
high school	高中 
huge block	巨大地段
idyllic family	田园诗般家庭区
impressive home	极美家居
inground pool	室外游泳池
large ensuite	特大套间 
lockable storage	带锁存储
maintained security	有保安
marble ensuite	大理石浴室
massive master	巨大主人房
middle floor	中间楼层
open home	开放式家居
outdoor spaces	户外空间
outdoor terrace	户外露台区
own inspections	自己检查
personal touch	个人精修
prime corner	黄金地段
private deck	私人甲板区
private driveway	私人车道
private inspection	检查
private leafy	私人绿荫
private outdoor	私人户外
private yard	私人庭院
prized north	珍贵北向
same family	一家人 
single lockup	单锁 
single remote	单个远程
small security	小保安
sought-after area	抢手地区
spacious design	宽敞设计
spacious floor	宽敞loucq
storage- internal	内部存储间
storey home	层楼家居
strong rent	极优租金
stunning property	惊人地段
stylish bathrooms	时尚浴室
stylish family	时尚家庭区
superior quality	卓越品质
teen retreat	青少年生活区
timber floor	木地板 
undercover area	有盖地区
undercover balcony	有盖阳台
urban living	城市生活
urban retreat	城市生活区
well-regarded schools	著名学校
lower level	低层
more information	更多信息
more bedrooms	更多卧室
guest powder	客人卫浴
best endeavours	尽最大努力
highest quality	最高质量
highest standard	最高标准
best streets	最好街道
finest streets	最好街道
guest accommodation	客人住宿间
highest standards	最高标准
air conditioning	空调
family home	家庭居所
shopping centre	购物中心
master bedroom	主卧室
train station	火车站
family room	家庭区
gas kitchen	燃气灶
split system	分体式空调
steel appliances	不锈钢家具
car space	停车位
gas cooking	燃气灶具
box hill	Box Hill
lounge room	休息室
powder room	化妆房
stone bench	石凳
family living	家庭生活
floor plan	楼层平面图
living areas	生活区
ground floor	地面
home buyers	购房者
master suite	主人套房
brick home	全砖家居
bench tops	台面
gas cooktop	燃气灶具
family bathroom	家庭浴室
secondary college	二级学院
meals area	用餐区
system air	分体式空调
bedroom apartment	卧室公寓
breakfast bar	早餐吧
stone benchtops	石台面
ceiling fans	吊扇
living spaces	生活空间
home offers	家居提供
lane cove	lane cove
city buses	城市公交车
stone kitchen	石质厨房
video intercom	可视对讲
bus services	巴士服务
shopping centres	购物中心
security building	安全建设
storage space	存储间
caesar stone	caesar stone
gourmet kitchen	美食厨房
school catchment	学区
dream home	梦想家居
corner block	角位地区
village shops	village shops
floor apartment	楼公寓
investment opportunity	投资机会
secure car	安全车库
quality finishes	优质装修
cycle air	循环空调
home office	家庭办公室
caesarstone kitchen	CaesarStone厨房
plantation shutters	百叶窗
land size	土地面积
water tank	雨水水箱
island bench	厨房小岛台
quality appliances	高质量家电
rumpus room	娱乐室
eastern freeway	东部高速公路
alarm system	报警系统
gas heating	燃气暖气
bedroom home	家里卧室
entertainment area	娱乐区
quality schools	优质学校
steel gas	不锈钢煤气
westfield doncaster	westfield doncaster
golf course	高尔夫球场
home buyer	购房者
year round	全年
district views	小区风景
stone benches	石椅上
resort style	度假式
forest hill	forest hill
hill central	hill central
study nook	读书区
swimming pool	游泳池
bbq area	烧烤区
epping boys	epping boys
westfield shopping	Westfield购物
inspection times	看房时间
living space	生活空间
robed bedrooms	衣柜卧室
bench top	台面
car spaces	汽车空间
timber floorboards	木地板
shopping village	购物区
security intercom	安全对讲系统
timber flooring	木地板
family residence	家庭居所
level home	楼层家居
tennis court	网球场
timber kitchen	原木厨房
plan design	开放式设计
plan lounge	开放式客厅
walking distance	步行直达
west public	west public
air conditioner	空调
storage cage	存储间
street parking	路边停车
school zone	学区
car garage	车库
entry foyer	入口门厅
gas fireplace	燃气壁炉
plan kitchen	开放式厨房
railway station	火车站
miele appliances	Miele电器
gas appliances	燃气器具
quality stainless	优质不锈钢
security alarm	安全警报
gold coast	黄金海岸
sydney cbd	悉尼CBD
city skyline	都市天际线
living zones	生活区
security complex	安全小区
browser address	浏览器地址
state school	state school
top ryde	top ryde
cheltenham girls	cheltenham girls
designer kitchen	设计式厨房
college zone	大学区
bus stop	公交站
gas cook	燃气器具
garden city	garden city
macquarie university	麦克里大学
city views	大都市风景
level lawns	水平草地
street frontage	慷慨临街
town centre	镇中心
sunnybank hills	sunnybank hills
media room	媒体室
auto garage	自动车库
maintenance living	便利生活
plan living	开放式客厅
three bedrooms	三卧室
brick construction	全砖结构
storage room	储藏室
water views	绝美临水景观
hill chase	hill chase
neutral bay	neutral bay
brick residence	全住宅
city bus	城市公交车
split level	分体式楼层
AN INSPECTION	看房
hill high	hill high
killara high	killara high
air con	空调
family area	家庭区
home features	家居特点
security parking	安全停车位
deakin university	deakin大学
text advising	文本通知
AGENT /	代理
CONTACT AGENT	联系中介
EMAIL AGENT	发邮件代理
interest click	兴趣点击
REGISTER YOUR	登记您
scott website	scott website
YOUR INTEREST	有意登记
bay window	海湾窗台
boutique block	精品地段
island kitchen	厨房小岛台
boronia office	boronia office
epping west	epping west
rowville office	Rowville办公室
smeg appliances	SMEG电器
wantirna office	wantirna office
hardwood floors	硬木地板
security car	安全车库
stamp duty	印花税
glass doors	玻璃门
real estate.com.au	real estate.com.au
westfield knox	westfield knox
apartment offers	公寓提供
sqm approx	平方米约
art deco	艺术装潢
city transport	都市交通
monash university	Monash大学
brick family	全砖家居
cook top	炉灶口
family lifestyle	家庭生活方式
golf club	高尔夫俱乐部
security block	安全地段
street appeal	街区魅力
bayswater office	Bayswater办公室
girls high	女高
bus stops	巴士站
gas cooktop-	燃气灶具—
blackburn station	blackburn station
development site	开发地段
basement car	地下室车
bus transport	公交
ground level	地面
entry level	入门级
water tanks	雨水水箱
city shopping	都市购物
council approval	地区政府批准
macquarie park	麦格理公园
ryde city	Ryde市
air conditioners	空调
gas log	木壁炉
minute walk	分钟步行
plan family	开放式家庭间
secure parking	安全停车位
boys high	男高
business park	business park
glass splashbacks	玻璃防溅板
range hood	抽油烟机
level block	水平地段
master retreat	主人休息间
side driveway	侧车道
station village	station village
car park	停车位
development potential	发展潜力
dining rooms	餐厅
shopping precinct	购物区
monash freeway	Monash高速公路
entertainment deck	娱乐甲板区
maintenance lifestyle	便利生活方式
quality fittings	优质配件
secure basement	安全地下室
storage area	存储间
doncaster secondary	doncaster secondary
north sydney	north sydney
study room	读书区
lockup garage	带锁车库
security system	安全系统
style kitchen	式厨房
train stations	火车站
quality inclusions	优质装置
street access	直达街头
timber deck	木材甲板
macquarie centre	麦格理中心
corner position	角位地区
laundry facilities	洗衣房
size approx	大小约
beverly hills	Bevely Hills
breakfast bench	早餐台
ceiling fan	吊扇
home presents	家居提供
level residence	楼层家居
roller door	卷帘门
blackburn lake	blackburn lake
alfresco entertaining	户外娱乐
child care	托儿所
express bus	Express总线
property features	地段特点
property offers	地段提供了
security doors	安全门
sunnybank plaza	sunnybank plaza
town residence	城镇住宅
alfresco dining	露天餐厅
brick veneer	砖贴面
floor boards	地板
layout features	布局特点
period features	早期特征优点
picture rails	挂画线
bath tub	浴缸
council rates	市政费
property availability	地段预期
study area	读书区
wine cellar	酒窖
carlingford court	carlingford court
east doncaster	east doncaster
miele gas	miele煤气
mount waverley	mount waverley
entrance hall	入口大厅
gas stove	煤气炉
investment property	投资物业
quality fixtures	优质装置
balmoral beach	Balmoral海滩
boutique complex	精品小区
brisbane cbd	布里斯班CBD
chadstone shopping	Chadstone购物
griffith university	griffith university
mosman village	mosman village
mount druitt	Mount Druitt
orchard grove	orchard grove
state high	state high
stone island	石质小岛台面
water rates	水费
cooking appliances	烹饪器具
maintenance gardens	便利花园
quality gas	优质煤气
security screens	安全网
teenage retreat	少年休息间
transport options	方便交通选择
catholic primary	天主教小学
chatswood chase	Chatswood Chase
glen waverley	glen waverley
gourmet gas	美食煤气
national park	国家公园
parramatta cbd	parramatta cbd
road shops	road shops
westfield garden	westfield garden
designer bathrooms	设计式浴室
guest bedroom	客人卧室
hardwood floorboards	硬木地板
kitchen features	厨房特点
master bedrooms	主卧室
visitor parking	访客停车
world class	顶级
blackburn high	blackburn high
bosch appliances	bosch电器
led lighting	LED照明
macquarie uni	麦格理大学
ryde shopping	ryde shopping
fruit trees	果树
home site	家居地段
laundry room	洗衣房
living rooms	起居室
owner occupiers	业主
security apartment	安全公寓
water system	雨水水箱
chatswood cbd	Chatswood CBD
east public	east public
eastwood station	eastwood station
north ryde	north ryde
north shore	north shore
warrigal road	warrigal road
waverley secondary	Waverley中学
lounge area	休息区
medium density	介质密度
outdoor flow	户外流动式
parking space	停车空间
porcelain tiles	瓷质砖
stone benchtop	石台面
designer bathroom	设计式浴室
epping station	epping station
harbour bridge	harbour bridge
north blackburn	north blackburn
pennant hills	pennant hills
strata levies	物业费
bedroom apartments	卧室公寓
home business	家居商业
home sits	家居稳坐
lawn area	草坪区
chadwick real	chadwick real
combustion fireplace	天然火炉
crows nest	crows nest
eastland shopping	Eastland购物
single lock-up	单锁
st leonards	st leonards
tunstall square	tunstall square
car parking	停车位
city bound	直达City
floor unit	层公寓
home theatre	家庭影院
luxury home	豪宅家居
privacy policy	隐私政策
rainwater tank	雨水罐
residence offers	住宅提供
shopping strip	购物区
spa bathroom	温泉浴室
brisbane city	布里斯班市
creek trail	creek trail
macquarie shopping	麦格理购物
off street	离街
park primary	公园小学
warrigal square	warrigal square
bay windows	海湾窗台
entry hall	入口大厅
golf courses	高尔夫球场
home owners	业主
minute drive	分钟车程
owner occupier	业主
property include	地段包括
split air	分体式空调
stone tops	石台面
tidy bathroom	整洁浴室
water feature	水池装饰
blackburn shopping	blackburn shopping
caesarstone bench	CaesarStone台
christian college	基督教学院
eight mile	eight mile
hurstville cbd	hurstville cbd
market square	market square
air conditioning*	空调
colour palette	颜色板
ferry wharf	渡轮码头
galley kitchen	厨房
gas bayonet	燃气器具
gas heater	燃气热水器
master ensuite	主人套房
site saturday	网站星期六
style home	式家居
james ruse	james ruse
public school.-	公立学校。—
smeg gas	SMEG煤气
village shopping	village shopping
family life	家庭生活
feature wall	设计墙
fire place	壁炉
gas cooking-	燃气灶具—
house storage	存储间
indoor/outdoor flow	室内/室外流动式
level backyard	水平后院
maintenance backyard	便利后院
powder rooms	化妆房
quality homes	优质家居
saltwater pool	海水游泳池
style living	式生活
bay run	海湾跑道
denistone east	denistone east
high street	高街
hyde park	hyde park
knox shopping	knox 购物
lindfield public	lindfield public
north primary	north primary
oak floors	橡木地板
square shopping	square shopping
vermont secondary	vermont secondary
bathroom features	浴室特有
bus routes	巴士路线
caesarstone island	CaesarStone岛
city express	直达City
control garage	控制车库
gas appliances-	燃气器具—
glass splashback	玻璃防溅板
land area	土地面积
level bedrooms	楼层卧室
log fire	壁炉
maintenance garden	便利花园
wood fire	燃木壁炉
blue mountains	蓝山
castle towers	castle towers
college catchment	学区
ducted reverse	导管空调
gas cooking*	燃气器具
hills shopping	hills shopping
lake sanctuary	lake sanctuary
ryde public	ryde public
security entry	安全入口
west primary	west primary
yarra valley	yarra valley
games room	游戏室
works fund	工程基金
ceiling tiles	天花板
facing balcony	面阳台
family sanctuary	家居天堂
home boasts	家居拥有
master room	主卧室
phone number	电话
photo id	身份证照片
polyurethane kitchen	聚氨酯厨房
seamless flow	漂亮流动式
secure complex	安全小区
shopping destinations	购物地点
street presence	街区魅力
surround sound	环绕声系统
veneer home	砖贴面住宅
village cafes	邻近咖啡馆
AT ALL	所有
blackburn south	blackburn south
caesarstone benchtops	Caesarstone台面
chatswood high	Chatswood高
chester hill	chester hill
federation home	联邦式家居
glen shopping	glen shopping
koonung creek	koonung creek
koonung secondary	koonung secondary
middle harbour	middle harbour
r3 medium	R3中
south shopping	south shopping
st ives	st ives
torrens title	torrens所有权
unit size	单位尺寸
ceiling glass	天花板玻璃
corner allotment	角位地区
express buses	Express公交车
floor tiles	地砖
intercom system	对讲系统
living zone	生活区
luxury living	奢侈生活
maintenance yard	便利园子
quality carpets	优质地毯
skyline views	地平线雅景
stone gas	石煤气
study apartment	书房公寓
weatherboard home	护墙住宅
bosch dishwasher	bosch洗碗机
capital works	资本运作
carlingford west	carlingford west
georges river	georges river
ilve gas	Ilve煤气
jackson court	jackson court
mile plains	mile plains
north east	东北
park shopping	公园购物
PLEASE NOTE	注意
st george	st george
burner gas	炉气
bus service	巴士服务
family meals	家庭餐室
garden setting	花园摆设
induction cooktop	电磁炉
inspection today	今天看房
living areas*	生活区*
log fireplace	壁炉
minutes’ walk	分钟路程
phase power	三相电源
quarter approx	季度约
r/c air	空调
tandem garage	串联车库
tennis courts	网球场
tidy kitchen	整洁厨房
double lock-up	双锁车库
green square	green square
hunters hill	hunters hill
hurstville station	hurstville station
king street	king street
lindellas real	lindellas real
premier location	优越地段
quality kitchen	优质厨房
rain water	雨水
ringwood east	ringwood east
ringwood secondary	ringwood 中学
road primary	road primary
surfers paradise	surfers paradise
sydney harbour	sydney harbour
willoughby girls	willoughby girls
willoughby public	willoughby public
pines shopping	pines shopping
family/meals area	家庭区/饭厅
apartment living	公寓生活
capital growth	资本增幅
designer finishes	设计师修饰
dressing room	更衣室
driveway access	车通道
home delivers	家居提供
home offering	家居提供
home showcases	家居提供
king size	特大号King床位
level design	level设计
maintenance courtyard	便利庭院
parking spaces	停车位
picket fence	栅栏
school catchments	学区
versatile floorplan	多功能平面布置图
water pool	水池
ALL INSPECTIONS	看房
boronia park	boronia park
brentford square	brentford广场
brisbane river	布里斯班河
calamvale central	calamvale中央
carlingford high	carlingford high
chatswood shopping	Chatswood购物
east village	east village
heights primary	heights primary
heights public	heights public
ID REQUIRED	需要身份证
INSPECTIONS PLEASE	看房请
luxury bathrooms	豪华浴室
moore park	moore park
park beach	公园海滩
REQUIRED AT	需在
road shopping	road shopping
side drive	侧车道
west ryde	west ryde
apartment features	公寓特点
brick apartment	全砖公寓
district views-	小区风景
galley style	厨房风格
hardwood timber	硬木木材
hostess kitchen	女主厨房
island breakfast	小岛早餐台
lap pool	游泳池
morning coffee	早晨咖啡
plan layout	开放式布局
play area	游戏区
please contact	请联系
quality appointments	高质量家电
quality stone	优质石材
ribbon location	蓝带地段
sitting room	客厅
caesarstone gas	CaesarStone气
calamvale community	calamvale社区
central shopping	购物中心
chatswood station	Chatswood站
community college	社区学院
darling harbour	情人港
ducted air-conditioning	管道式空调
eastern freeway/eastlink	东部高速公路/东
eastlink freeway	东环线高速公路
eastwood public	eastwood public
five bedrooms	五间卧室
gourmet caesarstone	美食CaesarStone
grove primary	grove primary
hill shopping	hill shopping
led lights	led lights
m2 motorway	M2高速公路
mckinnon secondary	mckinnon 中学
mullum mullum	mullum mullum
MUST BE	必须
olympic park	olympic park
road state	road state
south primary	south primary
street shops	street shops
tandem carport	串联车库
wentworth point	wentworth point
offers plenty	提供了很多
parents retreat	父母休息间
apartment captures	公寓包含
breakfast counter	早餐台
call today	今天致电
city living	都市生活
family haven	家庭港湾
family/dining room	家庭区/饭厅
glass splash	玻璃防溅板
glass windows	玻璃窗
level rumpus	level娱乐区
listing agent	代理
lounge/dining room	休息室/餐厅
luxury apartment	豪华公寓
property market	房地产市场
quality home	优质家居
rain shower	阵雨
round entertaining	圆娱乐区
secure block	安全地段
security cameras	安全摄像机
shower room	淋浴房
sound system	音响系统
storage areas	存储间
studio apartment	公寓
style apartment	式公寓
superb home	优越住宅
versatile layout	多功能布局
basement parking	地下停车场
board approval	董事会批准
burwood heights	burwood heights
east link	东环线
epping public	epping public
forest lake	forest lake
grove reserve	grove reserve
hill north	hill north
hills primary	hills primary
investment review	投资回顾
knox school	knox 学校
m4 motorway	M4高速公路
michael dempsey	michael dempsey
mont albert	mont albert
resort facilities	度假式设施
review board	外商投资审查委员会
roselands shopping	Roselands购物
rouse hill	Rouse Hill
ruffey lake	ruffey lake
secure intercom	安全对讲系统
shopping centre-	购物中心—
south bank	south bank
valley grammar	valley grammar
kitchen/meals area	厨房/用餐区
bathroom *	浴室*
bedroom suite	卧室套房
boat ramp	船用斜坡道
bus interchange	公交换乘站
colour scheme	色彩设计
development opportunity	发展机会
entry point	入口点
family retreat	家庭区
garden courtyard	花园庭院
garden sheds	花园棚间
home owner	业主
immaculate home	完美家居
kitchen appliances	厨房电器
laundry *	洗衣*
level apartment	楼层公寓
photo identification	photo identification
stacker doors	叠门
stainless gas	不锈钢煤气
storage cupboards	存储柜
tv room	电视室
water view	绝美临水景观
wood heater	燃木壁炉
artarmon station	Artarmon站
bexley north	Bexley North
botany bay	botany bay
burns bay	burns bay
burwood highway	burwood highway
butler’s pantry	配膳室
chatswood public	Chatswood公共
creek reserve	creek reserve
eastern suburbs	东区
general residential	普通住宅
hill golf	hill golf
hornsby westfield	hornsby westfield
kerrimuir primary	kerrimuir primary
kerrimuir shops	kerrimuir shops
ladies college	女学
lake park	lake park
medical centre	医疗中心
miele dishwasher	Miele洗碗机
north public	north public
oak timber	橡木木材
road public	road public
stockland mall	stockland mall
vermont south	vermont south
gloss cabinetry	光泽橱柜
alfresco balcony	露天阳台
bedroom villa	卧室别墅
boutique development	精品开发
building access	直达大楼
character home	个性设计家居
cooking kitchen	方便厨房
cycle a/c	循环空调
cycle cooling	循环冷气
cycle heating	循环暖气
family comfort	舒适家庭
freeway access	直达高速公路
front balcony	前阳台
garden outlook	园林外观
guest room	客房
home reveals	家居提供
indoor/outdoor entertaining	室内/室外娱乐区
investment portfolio	投资组合
layout offers	布局提供了
level garden	级园林
m2 block	M2块
maintenance home	便利家居
oak floorboards	橡木地板
river views	河景
specialty shops	专卖店
splash backs	防溅板
superb location	优越地点
transport interchange	运输交汇处
bay village	海湾小村
da approval	DA批准
fountain gate	fountain gate
four bedrooms	四间卧室
gardiners creek	gardiners creek
george vuong	george vuong
glass sliders	玻璃门
hill tafe	hill tafe
led downlights	LED筒灯
mosman bay	mosman bay
oversized master	超大主人房
picnic point	picnic point
security access	安全直通
sliding glass	滑动玻璃
st thomas	st thomas
sydney university	悉尼大学
three double	三双
trinity grammar	trinity grammar
wattle park	wattle park
accommodation comprises	住宿包括
air conditioning-	空调
apartment presents	公寓介绍
art kitchen	艺术装潢厨房
bamboo flooring	竹木地板
bedroom +	卧室+
boutique building	精品建筑
breakfast bar*	早餐吧*
car lock	汽车锁
care centre	护理中心
city buses.-	城市公交车
coffee machine	咖啡机
cycle air-conditioning	循环空调
designer style	设计师风格
dining space	饭厅空间
dream family	梦想家居
entertainment areas	娱乐区
entertainment precinct	娱乐区
family size	家庭规模大小
gas outlet	气体出口
gas points	气分
inspectionsinspection times	看房时间
interest today	现有兴趣
lawn areas	草坪区
level land	水平地段
life style	生活方式
luxury bathroom	豪华浴室
luxury ensuite	豪华套间
p/q approx	左右
park views	park views
parquetry floors	拼花地板
penthouse apartment	复式公寓
powder room-	化妆房
quality property	优质地段
security basement	安全地下室
sliding doors	滑动门
split systems	分体式空调
storey townhouse	层联排别墅
street car	街上车位
theatre room	剧院房间
auction day	拍卖日
authorities approval	机关批准
balwyn high	Balwyn高校
baulkham hills	Baulkham Hills
bbq facilities	烧烤设施
botanic gardens	植物园
burwood train	burwood train
city council	市议会
designer gas	设计师煤气
double lockup	双锁车库
downstairs bedroom	楼下卧室
eastwood heights	eastwood heights
erina fair	erina fair
government authorities	政府当局
hurstville westfield	hurstville westfield
kingswood college	kingswood college
laburnum primary	laburnum primary
leisure centre	休闲区
level yard	水平院子
macedon square	macedon square
macgregor state	macgregor state
mccubbin primary	mccubbin 小学
mowbray public	mowbray public
mullum creek	mullum溪
new farm	new farm
oak flooring	橡木地板
private hospital	私家医院
private rear	私人后
remote lock	遥控门 
roberts mccubbin	roberts mccubbin
scoresby secondary	scoresby secondary
square station	square station
state government	州政府
three bathrooms	三卫浴
westinghouse appliances	Westinghouse电器
yarra river	yarra river
alfresco setting	露天摆设
area features	区域特征
auto door	自动门
benchtop kitchen	台面厨房
boutique apartment	精品公寓
boutique shops	精品店
brick building	全砖建筑
brick duplex	全砖双工
building facilities	建筑设施
caesarstone benches	CaesarStone长椅
chef’s kitchen	厨师厨房
city access	直达City
corner spa	角落温泉池
door access	门直达
duty savings	省印花税
entertainment patio	娱乐庭院
family entertainer	家庭娱乐间
family rooms	家庭区
freestanding home	独立家居
gas bayonets	燃气器具
hardwood flooring	硬木地板
health club	健康俱乐部
home comprises	家居包括
inspection please	看房请
irrigation system	灌溉系统
lowset home	低便家居
luxury homes	豪宅家居
period details	历史装潢细节
quality timber	优质木材
secure building	安全建筑
security gate	安全门
security shutters	安全窗口
shopping centers	购物中心
shopping villages	购物区
shower screen	淋浴屏
steel kitchen	不锈钢厨房
steel miele	不锈钢Miele
stone breakfast	石台面早餐
store room	储藏室
vacuum system	真空系统
beaumont road	Beaumont路
blanco appliances	blanco 家电
both bedrooms	两间卧室
cbd bound	CBD束缚
chase shopping	Chase购物
cooks river	cooks river
dandenong ranges	dandenong农岭
east primary	东小学
elegant bathroom	优雅浴室
emmaus college	emmaus college
epping train	epping train
euro laundry	欧式洗衣间
function room	function空间
gate shopping	gate shopping
high catchment	学区
hill hospital	hill hospital
hope island	hope island
hornsby station	hornsby station
kent road	kent road
lakewood estate	lakewood estate
marina square	marina square
mitcham primary	mitcham小学
modern caesarstone	现代CaesarStone
modern stone	现代石
moreton bay	moreton bay
orpheum theatre	orpheum theatre
pacific fair	pacific fair
pacific motorway	pacific motorway
pinelands shopping	Pinelands购物
plaza shopping	购物广场
public school-	公立学校—
residential zone	住宅区
security intercom-	安全对讲系统—
spotted gum	spotted gum
sydney airport	悉尼机场
tennis club	网球俱乐部
total size	总大小
waterfront estate	滨海住宅
waverley christian	Waverley基督教
kitchen area	厨房面积