rear	后面
touches	修饰
premier	优质
living	客厅
fringe	#
prestige	优等
terrace	公寓
sanctuary	天堂般
levels	楼层
dining	饭厅
access	直通
master	主人房
gym	健身房
complex	建筑
trains	火车
aspect	面向
outlook	景观
executive	高管
title	所有权
security	保安
property	家居
BIR	#
retreat	间
entertainer	娱乐
entertainers	娱乐
pristine	高级
stunning	惊艳
inspect	参观
